                          Baptist Church : ['Baptist Church', 'Batist Church', 'Methodist Church', 'Nazalet Church', 'Nazareth Church', 'Pentecosta Church', 'Pentecostal Church']
                    Ramadhani M. Mvugalo : ['Ramadhani M. Mvugalo']
                                    Wdsp : ['Wdsp', 'Wssp']
                Tabora Municipal Council : ['Kigoma Municipal Council', 'Municipal Council', 'Songea Municipal Counci', 'Tabora Municipal Council']
            Rotary Club Of Usa And Moshi : ['Rotary Club Of Chico And Moshi', 'Rotary Club Of Usa And Moshi']
                                     Pci : ['Pci']
                             Safari Camp : ['Safari Camp', 'Safari Roya']
                                 Hesawza : ['Gesawa', 'Hasawa', 'Hesawa', 'Hesawwa', 'Hesawz', 'Hesawza', 'Hesswa', 'Hewawa', 'Hhesawa']
                                    Lcdg : ['Lcdg', 'Lgcdg']
                                 Kimkuma : ['Kimkuma']
                                     Rwi : ['Rwi']
                Luchelegu Primary School : ['Luchelegu Primary School', 'Manyota Primary School', 'S.P.C Pre-primary School', 'Upendo Primary School']
                                Redcross : ['Red Cross', 'Redcross']
                    Overland High School : ['Overland High School']
                    Makonde Water Supply : ['Holili Water Supply', 'Lawatefuka Water Supply', 'Losaa-kia Water Supply', 'Losakia Water Supply', 'Makondakonde Water Population', 'Makonde Water Population', 'Makonde Water Supply', 'Rural Drinking Water Supply', 'Rural Water Supply']
                                 Unknown : ['Unknown']
                                  Mbwiro : ['Mayiro', 'Mbwiro']
                             Magutu Maro : ['Magutu Maro']
                                  Dawasa : ['Auwasa', 'Bahewasa', 'Dawasa', 'Dawasco', 'Hewasa', 'Kuwasa', 'Lowasa', 'Muwasa', 'Sauwasa', 'Sawaka', 'Shawasa', 'Sowasa', 'Suwasa', 'Tuwasa']
                                   Godii : ['Godii']
                             Game Fronti : ['Game Fronti']
                                   Shule : ['Shule']
                                   Unhcr : ['Unhcr', 'Unicrf']
                                      Gt : ['Gt']
                  National Rural And Hfa : ['National Rural (wb)', 'National Rural And Hfa']
                Water Sector Development : ['Water Sector Development']
                                    Asdp : ['Afdp', 'Asdp', 'Dsdp', 'Wsdp']
                                    Drdp : ['Brdp', 'Dadp', 'Drdp', 'Dsdp']
                                      Gg : ['Gg']
                      Care International : ['Care International', 'Compasion International', 'Living Water International', 'Lotary International', 'Muslimehefen International', 'Plan International']
                                      Ga : ['Ga']
                               Sekondari : ['Secondary', 'Sekondari']
                                      Go : ['Go']
                               Sun-ja Na : ['Sun-ja Na']
                                 Padri K : ['Padri K']
                             Dwe And Veo : ['Doner And Ded', 'Dwe And Veo']
                                   Mianz : ['Mianz', 'Mwanza']
              International Aid Services : ['International Aid Services']
                              Care/cipro : ['Care/cipro']
                                Winkyens : ['Winkyens']
                                   Moses : ['Masese', 'Moses']
                             Quick Wings : ['Quick Win', 'Quick Wings', 'Quick Wins', 'Quickwins', 'Qwick Win', 'Tquick Wings']
                             Vgovernment : ['Belgian Government', 'China Government', 'Cipro/government', 'Danida /government', 'Egypt Government', 'Government', 'Irish Government', 'Isf/government', 'Italy Government', 'Japan Government', 'Misri Government', 'Norad /government', 'Norad/government', 'Overnment', 'Tcrs /government', 'Unhcr/government', 'Vgovernment', 'Village Government']
                                  Hesawz : ['Gesawa', 'Hasawa', 'Hesaw', 'Hesawa', 'Hesawwa', 'Hesawz', 'Hesawza', 'Hesswa', 'Hewawa', 'Hhesawa']
                                The Isla : ['The Isla', 'The Islamic']
                                   Dbspe : ['Dbfpe', 'Dbsp', 'Dbspe']
                       Christian Outrich : ['Christan Outrich', 'Christian Outrich', 'Cristan Outrich']
                                     Wwf : ['Wwf']
                                  Hesawa : ['Gesawa', 'Hasawa', 'Hesaw', 'Hesawa', 'Hesawwa', 'Hesawz', 'Hesawza', 'Hesswa', 'Hewasa', 'Hewawa', 'Hhesawa']
                            Town Council : ['Kibaha Town Council', 'Kyela Council', 'Town Council']
                              Us Embassy : ['Japan Embassy', 'Us Embassy', 'Usa Embassy']
                                    Bhws : ['Bhws', 'Bkhws']
                             Rombo Dalta : ['Rombo Dalta']
                                   Amref : ['Amref', 'Amrefe', 'Hamref']
                            Hapa Singida : ['Hapa Singida']
                                   Padri : ['Padi', 'Padri', 'Padri K']
                      Tanzania Compasion : ['Tanzania Compasion']
                        Anjuman E Seifee : ['Anjuman E Seifee']
                                     H/w : ['H/w']
          Tanzania Egypt Technical Co Op : ['Tanz Egypt Technical Cooper', 'Tanz/egypt Technical  Co-op', 'Tanzania Egypt Technical Co Op']
                              Kwa Makala : ['Kwa Makala']
                              Mbuzi Mawe : ['Mbuzi Mawe']
                                   Rafik : ['Rafik']
                          Comune Di Roma : ['Comune Di Roma', 'Comunedi Roma']
                                  Serian : ['Serian', 'Serikali', 'Serikari', 'Serikaru']
                                  Kamama : ['Kahema', 'Kajima', 'Kamama', 'Kanamama', 'Mwamama']
                           Prof. Saluati : ['Prof. Saluati']
                              Mkurugenzi : ['Mkurugenzi']
                             Unicef/cspd : ['Unice/ Cspd', 'Unicef/ Csp', 'Unicef/central', 'Unicef/cspd']
                             S.S Mohamed : ['S.S Mohamed']
                                 Incerto : ['Incerto', 'Investor']
                             Rudep/norad : ['Rudep/norad']
                        Redekop Digloria : ['Redekop Digloria']
                         Total Land Care : ['Total Land Care', 'Total Landcare', 'Totaland Care', 'Totoland Care']
                          Japan Food Aid : ['Japan Food', 'Japan Food Aid']
                                 Mtuwasa : ['Auwasa', 'Kuwasa', 'Liuwassa', 'Mbiuwasa', 'Mtuwasa', 'Muwasa', 'Sauwasa', 'Suwasa', 'Tuwasa']
                              Fini Water : ['Fin Water', 'Fini Water', 'Finn Water', 'Finwater', 'Wanginyi Water']
              Wamissionari Wa Kikatoriki : ['Wamisionari Wa Kikatoriki', 'Wamissionari Wa Kikatoriki']
                 Otelo Bussiness Company : ['Otelo Bussiness Company']
                       World Vision/adra : ['World Vision', 'World Vision/ Kkkt', 'World Vision/adra', 'World Vision/rc Church']
                                  Unicrf : ['Unicef', 'Uniceg', 'Unicet', 'Unicrf']
                                    Wama : ['Wama']
                          Wanginyi Water : ['Wanginyi Water']
                                 Makombo : ['Mafwimbo', 'Makombo']
                              Mzee Smith : ['Mzee Omari', 'Mzee Smith']
                          Jamal Abdallah : ['Jamal Abdallah', 'Mmanya Abdallah']
                                  Uniceg : ['Unice', 'Unicef', 'Uniceg', 'Unicet', 'Unicrf', 'Uniseg']
                                   Ngumi : ['Ngumi']
                            Perusi Bhoke : ['Perusi Bhoke']
                              Magoma Adp : ['Magoma Adp']
                                   Adp/w : ['Adp/w']
                                  Nordic : ['Nordic']
               Finidagermantanzania Govt : ['Finida German Tanzania Govt', 'Finidagermantanzania Govt']
                 Islamic Agency Tanzania : ['Islamic Agency Tanzania']
                                Totoland : ['Totoland', 'Totoland Care']
                                Swiss Tr : ['Swiss If', 'Swiss Tr']
                          Charlotte Well : ['Charlotte Well']
                                      Lg : ['Lg']
                                     Abd : ['Abd']
                                      Lc : ['Lc']
                          Unicef/central : ['Unicef/central']
                                  Wizara : ['Wizara']
                      Selikali Ya Kijiji : ['Selikali Ya Kijiji', 'Serikali Ya Kijiji']
                           Caltaz Kahama : ['Caltas Tanzania', 'Caltaz Kahama']
                                     Abs : ['Abs']
                              Kkkt Canal : ['Kkkt Canal', 'Kkkt Mareu', 'Kkkt_makwale']
                African Development Bank : ['Abc-ihushi Development Cent', 'African Development Bank', 'African Development Foundation']
                                     Liz : ['Liz']
                        Egypt Government : ['Belgian Government', 'China Government', 'Cipro/government', 'Colonial Government', 'Danida /government', 'Egypt Government', 'Finland Government', 'Irish Government', 'Italy Government', 'Japan Government', 'Misri Government', 'Norad /government', 'Norad/government', 'Tcrs /government', 'Unhcr/government', 'Village Government']
                           Kondo Primary : ['Kondo Primary']
                             Songa Hospi : ['Songa Hospi']
                              Kipo Potry : ['Kipo Potry']
                                Runduman : ['Rundu Man', 'Runduman']
                                 Muslims : ['Muslims']
                                     Ggm : ['Ggm']
                             Solar Villa : ['Solar Villa']
                                  Woyege : ['Woyege']
                                   Dimon : ['Dimon', 'Simone']
                                   Kijij : ['Kijij', 'Kijiji']
                                 Fiwater : ['Fin Water', 'Fini Water', 'Finn Water', 'Finwater', 'Fiwater', 'Kiliwater', 'Kilwater']
                             Kome Parish : ['Kalebejo Parish', 'Kome Parish']
                                     Tpp : ['Tpp']
                               Usaid/wfp : ['Usaid/wfp']
                      Rural Water Supply : ['Holili Water Supply', 'Lawatefuka Water Supply', 'Losaa-kia Water Supply', 'Losakia Water Supply', 'Makonde Water Supply', 'Rural Drinking Water Supply', 'Rural Water Department', 'Rural Water Supply', 'Rural Water Supply And Sanita', 'Rural Water Supply And Sanitat']
                                  Lusajo : ['Lusajo']
             Afya Department Lindi Rural : ['Afya Department Lindi Rural']
                          Neemia Mission : ['German Missionary', 'Germany Missionary', 'Heri Mission', 'Neemia Mission']
                        Irish Government : ['Belgian Government', 'British Colonial Government', 'China Government', 'Cipro/government', 'Colonial Government', 'Danida /government', 'Egypt Government', 'Finland Government', 'Irish Government', 'Isf/government', 'Italy Government', 'Japan Government', 'Misri Government', 'Norad /government', 'Norad/government', 'Tcrs /government', 'Unhcr/government', 'Village Government']
                               Fin Water : ['Fin Water', 'Fini Water', 'Finn Water', 'Finwater', 'Wanginyi Water']
                     Mheza Distric Counc : ['Mbozi District Council', 'Mheza Distric Counc', 'Mkinga  Distric Cou', 'Mkinga Distric Coun', 'Sangea District Council', 'Sengerema District Council', 'Songea District Council', 'Wb / District Council']
                       Germany Misionary : ['German Missionary', 'Germany Cristians', 'Germany Misionary', 'Germany Missionary']
                                    Bgss : ['Bgss', 'Bgssws']
                                 Quickwi : ['Quick Win', 'Quick Wins', 'Quicklw', 'Quickwi', 'Quickwins', 'Qwickwin']
                     Dwe/anglican Church : ['Anglican Church', 'Dwe/anglican Church']
                     Answeer Muslim Grou : ['Answeer Muslim Grou']
                                 Kondela : ['Kondela']
                                 Bahresa : ['Bahewasa', 'Bahresa']
                             Ilaramataki : ['Ilaramataki', 'Laramatak', 'Raramataki']
                     Rusumo Game Reserve : ['Rusumo Game Reserve']
                                      Il : ['Il']
                                    Hery : ['Hery']
                           Swalehe Rajab : ['Swalehe Rajab']
                          Kibo Brewaries : ['Kibo Brewaries']
                                 Milenia : ['Milenia', 'Millenium']
                                    Kidp : ['Kadp', 'Kidep', 'Kidp', 'Kirdep', 'Pidp']
                                   Bobby : ['Bobby']
                                Mtibwa S : ['Matimbwa Sec', 'Mtibwa S']
                    Ikeuchi Towels Japan : ['Ikeuchi Towels Japan']
                                  Malola : ['Makona', 'Malola']
                                  Kajima : ['Kahema', 'Kajima', 'Kamama', 'Kanisa']
                            Mboni Salehe : ['Mboni Salehe']
                           Lench Taramai : ['Lench Taramai']
                                   Tacri : ['Tacare', 'Tacri', 'Tancro']
                                 Vodacom : ['Vodacom']
                                  Sobodo : ['Sabodo', 'Sobodo']
                           Shabani Dunia : ['Shabani Dunia']
                           Saidi Halfani : ['Saidi Halfani']
                                S. Kumar : ['S. Kumar']
                                 Muivaru : ['Muivaru']
                                     Csf : ['Csf']
                                     Gtz : ['Gtz']
          Domestic Rural Development Pro : ['Domestic Rural Development Pr', 'Domestic Rural Development Pro']
                                   St Ph : ['St Ph']
                              Netherland : ['Natherland', 'Nerthlands', 'Nethalan', 'Netherla', 'Netherland', 'Netherlands']
                       Paffect Mwanaindi : ['Paffect Mwanaindi']
                                   Mhuzu : ['Mhuzu']
                                Water Se : ['Water /sema', 'Water Se', 'Wateraid']
                             Norad/rudep : ['Norad/ Kidep', 'Norad/rudep']
                                    Vttp : ['Vttp']
                                    Rssp : ['Rssp', 'Rwsp', 'Rwssp', 'Rwsssp', 'Wssp']
                         Usambala Sister : ['Usambala Sister']
             British Colonial Government : ['British Colonial Government', 'Colonial Government', 'Lwi & Central Government']
                                   Kikom : ['Kikom']
                                  Tredsp : ['Tredep', 'Tredsp', 'Treedap', 'Tridep']
                                      Vc : ['Vc']
                                   Nirad : ['Nirad', 'Norad']
                                 Ifakara : ['Ifakara']
                              Said Omari : ['Mbwana Omari', 'Mwalimu Omari', 'Mzee Omari', 'Said Omari']
                                     Pdi : ['Padi', 'Pdi']
                               Frankfurt : ['Frankfurt']
                                  Kagera : ['Kagera', 'Kahema', 'Magereza']
                        Selestine Mganga : ['Selestine Mganga']
                         Arabs Community : ['Arab Community', 'Arabs Community', 'Igolola Community', 'Ilwilo Community', 'Islamic Community', 'Marumbo Community', 'Maseka Community', 'Tcrs/village Community', 'Village Community']
                                    Rips : ['Lips', 'Rips']
                                   Tabea : ['Tabea', 'Taboma', 'Tadepa', 'Tahea']
               Kibaha Independent School : ['Kibaha Independent School']
                                   Niger : ['Niger']
                                   Miomb : ['Miomb']
                                  Hasawa : ['Gesawa', 'Hasawa', 'Hesawa', 'Hesawwa', 'Hesawz', 'Hesawza', 'Hesswa', 'Hewawa', 'Hhesawa']
                              Omary Issa : ['Omary Issa']
                              Nerthlands : ['Nerthlands', 'Netherland', 'Netherlands']
                    Makanya Sisal Estate : ['Makanya Sisal Estate']
                        Tcrs /government : ['China Government', 'Cipro/government', 'Danida /government', 'Egypt Government', 'Irish Government', 'Isf/government', 'Italy Government', 'Japan Government', 'Misri Government', 'Norad /government', 'Norad/government', 'Tcrs /government', 'Unhcr/government', 'World Bank/government']
                             Madaraweshi : ['Madaraweshi']
                           Villagers Mpi : ['Villagers Mpi']
                                   Wrssp : ['Drwssp', 'Nrwssp', 'Wrssp', 'Wssp']
                           Segera Estate : ['Mwelia Estate', 'Segera Estate']
                                Kalitesi : ['Kalitasi', 'Kalitesi']
                       Costantine Herman : ['Costantine Herman']
                           Water Aid/dwe : ['Wate Aid/sema', 'Water Aid /sema', 'Water Aid/dwe', 'Water Aid/sema']
                           Irevea Sister : ['Irevea Sister', 'Irevea Sister Water']
                                   Twice : ['Twice']
                                Qwickwin : ['Quick Win', 'Quick Wins', 'Quickwi', 'Quickwins', 'Qwckwin', 'Qwekwin', 'Qwick Win', 'Qwickwin']
                                Member O : ['Member O']
                       Deogratius Kasima : ['Deogratius Kasima']
                                  Kassim : ['Dassip', 'Kassim']
                                Trachoma : ['Trachoma']
                               Hortanzia : ['Hortanzia']
                                  Salehe : ['Balyehe', 'Salehe']
                           Tag Church Ub : ['Pag Church', 'Tag Church', 'Tag Church Ub']
                              Cipro/care : ['Cipro/care', 'Cipro/care/tcrs']
                                   Holla : ['Holla', 'Holland']
                  Manyota Primary School : ['Luchelegu Primary School', 'Manyota Primary School', 'S.P.C Pre-primary School', 'Upendo Primary School']
           Halmashauri Ya Wilaya Sikonge : ['Halmashauri Ya Manispa Tabora', 'Halmashauri Ya Wilaya', 'Halmashauri Ya Wilaya Sikonge']
                                  Makuru : ['Makori', 'Makuru', 'Makusa']
                       Poland Sec School : ['Longido Sec School', 'Overland High School', 'Poland Sec School', 'Tingatinga Sec School']
                     Roman Cathoric Same : ['Roman Catholic', 'Roman Cathoric', 'Roman Cathoric -kilomeni', 'Roman Cathoric Church', 'Roman Cathoric Same', 'Roman Cathoric-same']
                             Usa Embassy : ['Japan Embassy', 'Us Embassy', 'Usa Embassy']
                         Village Council : ['District Council', 'Kyela Council', 'Village Communi', 'Village Community', 'Village Contributio', 'Village Council', 'Village Council/ Rose Kawala', 'Village Fund', 'Village Government', 'Village Office', 'Villege Council', 'Villlage Contributi']
                                  Uniseg : ['Unicef', 'Uniceg', 'Unicet', 'Uniseg']
                      Concern World Wide : ['Concern World Wide', 'Hesawa And Concern World Wide']
                                    Theo : ['Theo']
                                   Tanap : ['Tanap', 'Tanapa', 'Tancan']
                                     Asb : ['Asb']
                                     Dgv : ['Dgv']
                                 Patrick : ['Patrick']
                                   Mdrdp : ['Mdrdp', 'Ndrdp']
                              Missionary : ['German Missionary', 'Germany Missionary', 'Missionaries', 'Missionary', 'Rc Missionary']
                                   Pwagu : ['Pwagu']
                                 Abas Ka : ['Abas Ka', 'Abasia']
                         Cartas Tanzania : ['Caltas Tanzania', 'Cartas Tanzania', 'Plan Tanzania']
                                     Jbg : ['Jbg']
                                 Sagaswe : ['Sagaswe']
                         Islamic Society : ['Islamic Community', 'Islamic Society', 'Muslim Society']
                                    Sida : ['Cida', 'Fida', 'Sida', 'Sido', 'Sisa', 'Soda']
                           Wfp/usaid/tnt : ['Wfp/usaid/tnt']
                                   Tansi : ['Tansi']
                 Happy Watoto Foundation : ['Happy Watoto Foundation']
                                Gwitembe : ['Gwitembe']
                                   Sao H : ['Sao H']
                                       R : []
                               Ces(gmbh) : ['Ces (gmbh)', 'Ces(gmbh)']
                                   Mambe : ['Mambe', 'Mnyambe', 'Mtambo']
                                   Marke : ['Marke']
                                Nyabweta : ['Nyabweta']
                     Roman Cathoric-same : ['Roman Catholic', 'Roman Cathoric', 'Roman Cathoric -kilomeni', 'Roman Cathoric Church', 'Roman Cathoric Same', 'Roman Cathoric-same']
                                   Ldcdd : ['Ldcdd', 'Ldcgd']
                    In Memoria Di Albeto : ['In Memoria Di Albeto']
                       Municipal Council : ['Kigoma Municipal Council', 'Municipal Council', 'Songea Municipal Counci', 'Tabora Municipal Council']
                                  Huches : ['Huches']
                             Worldvision : ['World Vision', 'World Vision/ Kkkt', 'World Vision/adra', 'Worldvision']
                                Solidame : ['Solidame', 'Solidarm', 'Soliderm']
                                 Muislam : ['Muislam']
                                 M And P : ['M And P']
                               Raurensia : ['Raurensia']
                                  Msigwa : ['Msigw', 'Msigwa']
               Desk And Chair Foundation : ['Desk And Chair Foundation', 'The Desk And Chair Foundat']
                                 Tasaf 1 : ['Tasaf 1', 'Tasaf Ii', 'Tasafu', 'Tassaf I', 'Tassaf Ii']
                          Motiba Wambura : ['Motiba Manyanya', 'Motiba Wambura', 'Rhobi Wambura', 'Teonas Wambura']
                       Bread Of The Worl : ['Bread For The Wor', 'Bread Of The Worl']
                 Dwe/ubalozi Wa Marekani : ['Dwe/ubalozi Wa Marekani', 'Ubalozi Wa Marekani']
                       Ministry Of Water : ['Ministry Of Agricultura', 'Ministry Of Education', 'Ministry Of Healthy', 'Ministry Of Water']
                                  Others : ['Others']
                                  Hesswa : ['Gesawa', 'Hasawa', 'Hesawa', 'Hesawwa', 'Hesawz', 'Hesawza', 'Hesswa', 'Hewawa', 'Hhesawa']
                              Sda Church : ['Agt Church', 'Aic Church', 'Fpct Church', 'Kkkt Church', 'Nazalet Church', 'Pag Church', 'Rc Church', 'Roman Church', 'Sda Church', 'Tag Church']
                             Lga And Adb : ['Lga And Adb']
                             Netherlands : ['Natherland', 'Nerthlands', 'Netherla', 'Netherland', 'Netherlands']
                                Ikela Wa : ['Ikela Wa']
                       Village Community : ['Arab Community', 'Arabs Community', 'Buluga Subvillage Community', 'Igolola Community', 'Ilwilo Community', 'Islamic Community', 'Kitiangare Village Community', 'Marumbo Community', 'Maseka Community', 'Ngiresi Village Community', 'Okutu Village Community', 'Oldadai Village Community', 'Olgilai Village Community', 'Sekei Village Community', 'Tcrs/village Community', 'Village Communi', 'Village Community', 'Village Contributio', 'Village Council', 'Village Government', 'Village Water Commission', 'Villege Council', 'Villlage Contributi']
                                   Gaica : ['Gaica', 'Jaica']
                                   Duwas : ['Auwasa', 'Dawasa', 'Duwas', 'Kuwasa', 'Muwasa', 'Suwasa', 'Tuwasa']
                        Ilwilo Community : ['Arab Community', 'Arabs Community', 'Igolola Community', 'Ilwilo Community', 'Islamic Community', 'Marumbo Community', 'Maseka Community', 'Tcrs/village Community', 'Village Community']
                                  Hewasa : ['Auwasa', 'Bahewasa', 'Dawasa', 'Hesawa', 'Hewasa', 'Hewawa', 'Kuwasa', 'Lowasa', 'Muwasa', 'Sowasa', 'Suwasa', 'Tuwasa']
                                   Quick : ['Quick', 'Quicklw', 'Quickwi', 'Quik']
                                  Sawaka : ['Dawasa', 'Sauwasa', 'Sawaka', 'Shawasa', 'Sowasa', 'Suwasa']
                              Tcrs /care : ['Tcrs /care', 'Tcrs/care']
                              Singasinga : ['Singasinga', 'Singsinga']
               Oldadai Village Community : ['Buluga Subvillage Community', 'Kitiangare Village Community', 'Ngiresi Village Community', 'Okutu Village Community', 'Oldadai Village Community', 'Olgilai Village Community', 'Sekei Village Community', 'Tcrs/village Community']
                                   W.D & : ['W.D &', 'W.D & I.']
                                  I Wash : ['I Wash']
                              Norway Aid : ['Norway Aid']
                        Zao Water Spring : ['Zao Water Spring', 'Zao Water Spring X']
                                  Noshad : ['Noshad', 'Noshadi']
                        Methodist Church : ['Baptist Church', 'Batist Church', 'Eung Am Methodist Church', 'Eung-am Methodist Church', 'Methodist Church', 'Morovian Church', 'Pentecosta Church', 'Pentecostal Church']
                 Hotels And Loggs Tz Ltd : ['Hotels And Lodge Tanzania', 'Hotels And Loggs Tz Ltd']
                           Kwaruhombo He : ['Kwaruhombo He']
                                Hospital : ['Hospital', 'Mbozi Hospital']
                         Kwa Mzee Waziri : ['Kwa Mzee Waziri']
                                   Lgdcg : ['Lgdbg', 'Lgdcg']
                               Eco Lodge : ['Eco Lodge']
                      Ramadhani Nyambizi : ['Ramadhani Nyambizi']
                  Tcrs/village Community : ['Buluga Subvillage Community', 'Kitiangare Village Community', 'Ngiresi Village Community', 'Okutu Village Community', 'Oldadai Village Community', 'Olgilai Village Community', 'Sekei Village Community', 'Tcrs/village Community', 'Village Community']
                                     Efg : ['Efg']
                    Nyamongo Gold Mining : ['Nyamongo Gold Mining']
                                   Dwarf : ['Dwarf']
                             Mzee Ngwatu : ['Mzee Ngwatu']
                                   Water : ['Eater', 'Water', 'Water Se', 'Wateraid']
                               Laramatak : ['Ilaramataki', 'Laramatak', 'Parastatal', 'Raramataki']
                                   Makli : ['Makli', 'Makori']
                           Hasnein Murij : ['Hasnein Muij Mbunge', 'Hasnein Murij']
                  Losaa-kia Water Supply : ['Holili Water Supply', 'Lawate Fuka Water Suppl', 'Lawatefuka Water Supply', 'Losaa-kia Water Supply', 'Losakia Water Supply', 'Makonde Water Supply', 'Rural Drinking Water Supply', 'Rural Water Supply']
                                    Dwst : ['Dwsp', 'Dwst']
                               Ded/rwssp : ['Ded/rwssp', 'Ded_rwsp']
                                  Rumaki : ['Rumaki', 'Semaki']
                       Sumbawanga Munici : ['Sumbawanga Munici']
                                     Bgm : ['Bgm']
                                  Simavi : ['Semaki', 'Simav', 'Simavi']
                                   Hifab : ['Hifab']
                   Ministry Of Education : ['Ministry Of Agricultura', 'Ministry Of Education', 'Ministry Of Healthy', 'Ministry Of Water']
                                Resolute : ['Resolute']
                               Mh Kapuya : ['Mh Kapuya']
                            Drv Na Idara : ['Drv Na Idara']
                             Farm Africa : ['Farm Africa', 'Farm-africa']
                                   Menon : ['Menon']
                                   Lidep : ['Kidep', 'Kirdep', 'Lidep', 'Ridep', 'Tridep']
                             Muhameid Na : ['Muhameid Na']
                               Greineker : ['Greinaker', 'Greineker']
                                   Mhina : ['Mahita', 'Mhina']
                                   Rwsso : ['Rwsso', 'Rwssp', 'Rwsssp']
                                   Lvemp : ['Lvemp', 'Rvemp']
                               Pentecost : ['Pentecost', 'Pentecosta Seela', 'Pentecostal', 'Pentekoste']
                                  Taboma : ['Taboma', 'Trachoma']
                                 Sunamco : ['Sunamco']
                      Serikali Ya Kijiji : ['Selikali Ya Kijiji', 'Serikali Ya Kijiji']
                Haydom Lutheran Hospital : ['Haidomu Lutheran Church', 'Haydom Lutheran Hospital']
                                   Rwssp : ['Drwssp', 'Dwssp', 'Nrwssp', 'Nwssp', 'Rssp', 'Rwsp', 'Rwsso', 'Rwssp', 'Rwsssp']
                   Hasnan Murig (mbunge) : ['Hasnan Murig (mbunge)', 'Hasnein Muij Mbunge']
                 Lawatefuka Water Supply : ['Lawate Fuka Water Suppl', 'Lawatefuka Water Supply', 'Losaa-kia Water Supply', 'Losakia Water Supply', 'Makonde Water Supply', 'Rural Drinking Water Supply']
                          Kyela-morogoro : ['Kyela-morogoro']
                                     Sdp : ['Sdp']
                        Kigoma Municipal : ['Kigoma Municipal', 'Kigoma Municipal Council']
                                     Sdg : ['Sdg']
                                     Pwc : ['Pwc']
                                    Kmcl : ['Kmcl']
                                     Crs : ['Crs']
                                     Fdc : ['Fdc']
                                 Tanesco : ['Tanesco', 'Tanzakesho', 'Unesco']
                               Acord Ngo : ['Acord Ngo']
                               Angrikana : ['Angrikana']
              Muslimehefen International : ['Compasion International', 'Living Water International', 'Muslimehefen International']
                         Kwamdulu Estate : ['Kwamdulu Estate']
                                      Co : ['Co']
                                  Lowasa : ['Auwasa', 'Dawasa', 'Hewasa', 'Kuwasa', 'Liuwassa', 'Lowasa', 'Muwasa', 'Sowasa', 'Suwasa', 'Tuwasa']
                                   Mgaya : ['Mganga', 'Mgaya', 'Mungaya']
                  Eastmeru Medium School : ['Eastmeru Medium School', 'Prince Medium School']
                                      Cg : ['Cg']
                 Fresh Water Plc England : ['Fresh Water Plc England']
                                    Pidp : ['Kidp', 'Pidp']
                             Mzee Mabena : ['Mzee Mabena']
                                 Kauzeni : ['Kauzeni']
                              Pentekoste : ['Pentecost', 'Pentecosta Seela', 'Pentecostal', 'Pentekoste']
                                   Engin : ['Engin']
                          Saleh Zaharani : ['Saleh Zaharani']
                                  Tancro : ['Tancan', 'Tancro']
                             John Gileth : ['John Gileth']
                                   Rudep : ['Redep', 'Ridep', 'Rudep']
                         Village Communi : ['Kitiangare Village Community', 'Ngiresi Village Community', 'Okutu Village Community', 'Oldadai Village Community', 'Olgilai Village Community', 'Sekei Village Community', 'Tcrs/village Community', 'Village Communi', 'Village Community', 'Village Contributio', 'Village Council', 'Village Fund', 'Village Government', 'Village Water Commission', 'Villege Council', 'Villlage Contributi']
                      Full Gospel Church : ['Full Gospel Church', 'Pentecostal Church']
                                 Kolopin : ['Kolopin']
                                   Dadid : ['Dadid', 'Dadis', 'Dagida', 'Danida']
                               Quickwins : ['Quick Win', 'Quick Wings', 'Quick Wins', 'Quickwi', 'Quickwins', 'Qwickwin', 'Tquick Wings']
                           Mazaro Kabula : ['Mazaro Kabula']
                       Nyabarongo Kegoro : ['Nyabarongo Kegoro']
                                   Kirde : ['Kirde', 'Kirdep']
                                Mhoranzi : ['Mhoranzi', 'Uhoranzi']
                                   Dadis : ['Dadid', 'Dadis', 'Dads']
                                  Unesco : ['Tanesco', 'Unesco']
                                     Svn : ['Svn']
                          Samweli Kitana : ['Samweli Kitana', 'Samweli Mshosha']
                                Semaki K : ['Semaki', 'Semaki K']
                                   Sipdo : ['Sido', 'Sipdo']
                         Kenyans Company : ['Kenyans Company']
                      Bonite Bottles Ltd : ['Bonite Bottles Ltd']
                                Rc Msufi : ['Rc Missi', 'Rc Msufi']
                                    Nado : ['Iado', 'Nado', 'Tado']
                                    Cmcr : ['Cmcr', 'Cmsr']
                                    Tcrs : ['Tcrs', 'Tcrst', 'Tdrs', 'Tgrs']
                                   Uyoge : ['Uyoge']
                                     Cdg : ['Cdcg', 'Cdg']
                                      Vi : ['Vi']
                                     Nsc : ['Nsc']
                                      Vn : ['Vn']
                         Halmashauri Wil : ['Halmashauri', 'Halmashauri Wil', 'Halmashauri Ya Wilaya']
                                      Vw : ['Vw']
                            Mbwana Omari : ['Mbwana Omari', 'Mwalimu Omari']
                  Maswi Drilling Co. Ltd : ['Maswi Drilling Co. Ltd']
             Embasy Of Japan In Tanzania : ['Embasy Of Japan In Tanzania']
                        Kombe Foundation : ['Bingo Foundation', 'Goldwill Foundation', 'Kibara Foundation', 'Kombe Foundation', 'Kuji Foundation', 'Moslem Foundation']
                                   Norad : ['Morad', 'Moradi', 'Nirad', 'Norad', 'Norani', 'Noshad']
             Swisland/mount Meru Flowers : ['Swisland/ Mount Meru Flowers', 'Swisland/mount Meru Flowers']
                                     Kcu : ['Kcu']
                             Agape Churc : ['Agape Churc', 'Agt Church', 'Nazalet Church']
                                Chmavita : ['Camavita', 'Chamavita', 'Chmavita']
                                       D : []
                                     Trc : ['Trc']
                                    Ncaa : ['Ncaa']
                     Kibaha Town Council : ['Kibaha Town Council']
                                 Tanload : ['Tanload', 'Tanroad']
                                    Kdpa : ['Kdpa']
                                  Makusa : ['Makona', 'Makundya', 'Makuru', 'Makusa', 'Mbiusa']
           Hesawa And Concern World Wide : ['Hesawa And Concern World Wide']
             Water Project Mbawala Chini : ['Water Project Mbawala Chini']
                                 Mahemba : ['Kahema', 'Mahemba']
                           Kopwe Khalifa : ['Kopwe Khalifa']
                                Mzee Don : ['Mzee Don']
                            Mwita Muremi : ['Mwita Mahiti', 'Mwita Muremi']
                        Maashumu Mohamed : ['Maashumu Mohamed']
                        Bio Fuel Company : ['Bio Fuel Company']
                         Resolute Mining : ['Resolute Mining', 'Resolute Mininggolden Pride']
                  Jeshi La Wokovu [cida] : ['Jeshi La Wokovu [cida]']
                                    Mmem : ['Mmem']
                            Missionaries : ['Missionaries', 'Missionary']
                               Wd And Id : ['Wd And Id', 'Wua And Ded', 'Wug And Ded']
                    Lotary International : ['Care International', 'Compasion International', 'Living Water International', 'Lotary International', 'Muslimehefen International', 'Plan International']
                            Halimashauli : ['Halimashau', 'Halimashauli', 'Halmashauli', 'Halmashaur', 'Halmashauri', 'Halmashauri Wil']
                                Gurdians : ['Gurdians']
                                  School : ['Schoo', 'School']
                                 Treedap : ['Tredep', 'Tredsp', 'Treedap']
                                    Alia : ['Alia']
                                   Ldcgd : ['Lcgd', 'Ldcdd', 'Ldcgd', 'Lgcgd']
                           Nduku Village : ['Ilkeri Village', 'Nduku Village']
                                  Sweden : ['Sweden', 'Sweeden']
                                     Rdc : ['Rdc']
                                   Mwita : ['Mahita', 'Mwita']
              Quick Win Project /council : ['Quick Win Project /council']
                                Rotery C : ['Lottery Club', 'Rotary Club', 'Rotary I', 'Rotery C']
                                    Padi : ['Padi', 'Padri']
                              Canada Aid : ['Canada Aid']
                               Mwl.Mwita : ['Mwl.Mwita']
                                  Senapa : ['Kinapa', 'Senapa', 'Tanapa']
                                    Rdws : ['Rdws']
                                 Mama Ku : ['Mama Ku']
           Ju-sarang Church' And Bugango : ["Ju-sarang Church' And Bugango"]
                 Lawate Fuka Water Suppl : ['Lawate Fuka Water Suppl', 'Lawatefuka Water Supply', 'Losaa-kia Water Supply', 'Losakia Water Supply']
                   Roman Cathoric Church : ['Eung-am Methodist Church', 'Roman Cathoric -kilomeni', 'Roman Cathoric Church', 'Roman Cathoric Same', 'Roman Cathoric-same']
                                 Swedish : ['Swedish', 'Swidish']
                                     Ncs : ['Ncs']
                         Caltas Tanzania : ['Caltas Tanzania', 'Cartas Tanzania', 'Plan Tanzania']
                             Luali Kaima : ['Luali Kaima']
                                  Diwani : ['Diwani']
                         Mmanya Abdallah : ['Jamal Abdallah', 'Mmanya Abdallah']
                           Padep(mifugo) : ['Padep(mifugo)']
                               Q-sem Ltd : ['Q-sem Ltd']
                                Cathoric : ['Cathoric', 'Rc Cathoric', 'Roman Cathoric']
                                 Kegocha : ['Kegocha']
                              Mwakalinga : ['Mwakalinga']
                  World Vision/rc Church : ['World Vision/ Kkkt', 'World Vision/rc Church']
                           Mzee Shindika : ['Mzee Shindika', 'Timothy Shindika']
                             The Islamic : ['The Isla', 'The Islamic']
                                    Hans : ['Hans']
                                Walokole : ['Walokole']
                                  Mosque : ['Mosque', 'Mosqure']
                                   Lgdbg : ['Lgcbg', 'Lgdbg', 'Lgdcg']
                           Tlc/community : ['Arab Community', 'Ilwilo Community', 'Islamic Community', 'Tlc/community']
                                Lion Clu : ['Lion Clu', 'Lions Club']
                                  Mbiusa : ['Makusa', 'Mbiusa', 'Mbiuwasa']
                        District Medical : ['District Council', 'District Medical']
                  Regwa Company Of Egpty : ['Regwa Company Of Egpty', 'Regwa Company Of Egypt']
                                    Dadp : ['Dacp', 'Dadp', 'Dads', 'Dasp', 'Drdp', 'Dsdp', 'Kadp']
                                    Dads : ['Dadis', 'Dadp', 'Dads']
                                  Belgij : ['Belgij']
                               Adp Mombo : ['Adp Mombo']
                              Subvillage : ['Subvillage']
                        Tree Ways German : ['Tree Ways German']
                                  Tasafu : ['Taasaf', 'Tasaf', 'Tasaf 1', 'Tasaf Ii', 'Tasafu', 'Tassaf', 'Tassaf I']
                           National Park : ['National Park', 'National Rural']
                                     Oda : ['Oda']
                                  Makori : ['Makona', 'Makori', 'Makuru']
                                Mp Mloka : ['Mp Mloka']
               Hotels And Lodge Tanzania : ['Hotels And Lodge Tanzania', 'Hotels And Loggs Tz Ltd']
                                     Dwe : ['Dwe']
                      Germany Missionary : ['German Missionary', 'Germany Cristians', 'Germany Misionary', 'Germany Missionary']
                                     Cgi : ['Cgi']
                                  Gesawa : ['Gesawa', 'Hasawa', 'Hesawa', 'Hesawwa', 'Hesawz', 'Hesawza', 'Hesswa', 'Hewawa', 'Hhesawa']
                                   Trach : ['Trach', 'Trachoma']
                                   Piusi : ['Piusi']
                  Lions Club Kilimanjaro : ['Diocese Of Mount Kilimanjaro', 'Lions Club Kilimanjaro']
                           Mwinjuma Mzee : ['Mwinjuma Mzee']
                        Pentecosta Seela : ['Pentecosta Church', 'Pentecosta Seela', 'Pentecostal Church', 'Pentecostal Hagana Sweeden']
              Pentecostal Hagana Sweeden : ['Pentecostal Hagana Sweeden']
                       Salim Ahmed Salim : ['Salim Ahmed Salim']
           Koica And Tanzania Government : ['Koica And Tanzania Government']
                                  Juhibu : ['Juhibu']
                                   Runda : ['Runda', 'Runduman']
                                     Idf : ['Idf']
                                     Idc : ['Idc']
                    Cdtfdistrict Council : ['Cdtfdistrict Council', 'District Council', 'Mbozi District Council', 'Sangea District Council', 'Sengerema District Council', 'Songea District Council', 'Wb / District Council']
                              Mavuno Ngo : ['Mavuno Ngo']
                                 Nchagwa : ['Nchagwa']
                                 Mission : ['Cpps Mission', 'Heri Mission', 'Missio', 'Mission', 'Missionaries', 'Missionary', 'Rc Mission', 'Rc/mission']
                      Pentecostal Church : ['Full Gospel Church', 'Pentecosta Church', 'Pentecosta Seela', 'Pentecostal Church']
                                    Dmdd : ['Dmdd', 'Dmmd']
                         Plan Internatio : ['Care International', 'Compasion International', 'Lotary International', 'Plan Internatio', 'Plan International']
                Roman Cathoric -kilomeni : ['Roman Catholic Rulenge Diocese', 'Roman Cathoric -kilomeni', 'Roman Cathoric Church', 'Roman Cathoric Same', 'Roman Cathoric-same']
                   Quick Win/halmashauri : ['Quick Win/halmashauri']
                               Qwick Win : ['Quick Win', 'Quick Wings', 'Quick Wins', 'Qwick Win', 'Qwickwin', 'Tquick Wings']
                                 Artisan : ['Artisan']
                            Mwita Mahiti : ['Mwita Machota', 'Mwita Mahiti', 'Mwita Muremi']
                                  Songas : ['Songas']
                                     Dak : ['Dak']
                                       0 : []
                                Pankrasi : ['Pancrasi', 'Pankrasi']
                                  Ripati : ['Ripati']
                               Secondary : ['Secondary', 'Secondary Schoo', 'Sekondari']
                                   Abood : ['Abood']
                                  Rc/dwe : ['Rc/dwe']
                          Toronto-estate : ['Toronto-estate']
                                     Cip : ['Cip']
                        Bingo Foundation : ['Bingo Foundation', 'Bingo Foundation Germany', 'Goldwill Foundation', 'Kibara Foundation', 'Kombe Foundation', 'Kuji Foundation', 'Moslem Foundation']
                               Pangadeco : ['Pangadeco']
                                  Clause : ['Clause']
                 Shinyanga Shallow Wells : ['Shinyanga Shallow Wells']
                          Tasaf And Mmem : ['Tasaf And Lga', 'Tasaf And Mmem']
                                Kilwater : ['Finwater', 'Fiwater', 'Kiliwater', 'Kilomber', 'Kilwater']
                                     Tag : ['Tag']
                                  Vwcvwc : ['Vwcvc', 'Vwcvwc']
                                  Mayiro : ['Mataro', 'Mayiro', 'Mbwiro']
                                      He : ['He']
                 Kwang-nam Middle-school : ['Kwang-nam Middle-school']
                                  Kuwasa : ['Auwasa', 'Dawasa', 'Hewasa', 'Kuwait', 'Kuwasa', 'Liuwassa', 'Lowasa', 'Mbiuwasa', 'Mtuwasa', 'Muwasa', 'Sauwasa', 'Sowasa', 'Suwasa', 'Tuwasa']
                                    Tgrs : ['Tcrs', 'Tdrs', 'Tgrs', 'Tgts']
                                  Sema S : ['Sema S', 'Semaki', 'Semaki K']
            Diocese Of Mount Kilimanjaro : ['Diocese Of Mount Kilimanjaro']
                           Rajab Seleman : ['Matata Selemani', 'Rajab Seleman', 'Rajabu Athumani', 'Yasini Selemani']
                                   Ridep : ['Kidep', 'Kirdep', 'Lidep', 'Redep', 'Ridep', 'Rudep', 'Tridep']
                                    Cpar : ['Cpar', 'Cper']
                                   Fathe : ['Fathe', 'Father W']
                              Chai Wazir : ['Chai Wazir', 'Sophia Wazir']
                      Asgerali N Bharwan : ['Asgerali N Bharwan']
                             Pius Msekwa : ['Pius Msekwa']
                         Lutheran Church : ['Anglican Church', 'Haidomu Lutheran Church', 'Lutheran Church', 'Methodist Church', 'Morovian Church']
                             Salamu Kita : ['Salamu Kita']
                                      Md : ['Md']
             Giovan Disinistra Per Salve : ['Giovan Disinistra Per Salve']
                                      Ma : ['Ma']
              Friedkin Conservation Fund : ['Comunity Construction Fund', 'Fredked Conservation', 'Friedkin Conservation Fund']
                                      Mi : ['Mi']
                                      Mp : ['Mp']
                                      Ms : ['Ms']
                           Simon Lusambi : ['Simon Lusambi']
           Oikos E.Africa/european Union : ['Oikos E .Africa/european Union', 'Oikos E.Africa/ European Union', 'Oikos E.Africa/european Union']
            Unicef/african Muslim Agency : ['African Muslim Agency', 'Unicef/african Muslim Agency']
                                   I.E.C : ['I.E.C']
                         Kalebejo Parish : ['Kalebejo Parish', 'Kilimarondo Parish', 'Loliondo Parish']
                                 Simmors : ['Simmors']
                    Prince Medium School : ['Eastmeru Medium School', 'Prince Medium School']
                                Roman Ca : ['Roman Ca', 'Roman Catholic', 'Roman Cathoric', 'Roman Church']
                                Rc Churc : ['Agt Church', 'Aic Church', 'Fpct Church', 'Pag Church', 'Rc Cathoric', 'Rc Churc', 'Rc Church', 'Roman Church', 'Sda Church', 'Tag Church']
                         Concern /govern : ['Concern /govern', 'Concern/governm']
                                 Rc Mofu : ['Rc Mofu', 'Rc Msufi']
                                Africare : ['Africa', 'African', 'Africare']
                              Erre Kappa : ['Erre Kappa']
                               Meko Balo : ['Meko Balo']
                           Tina/africare : ['Tina/africare']
                                    Dacp : ['Dacp', 'Dadp', 'Dasp']
                                 Tanroad : ['Tanload', 'Tanroad']
                                Wananchi : ['Wananchi']
                                 Babtist : ['Babtest', 'Babtist', 'Buptist']
                               Overnment : ['Government', 'Isf/government', 'Overnment', 'Vgovernment']
                                  Kijiji : ['Kijij', 'Kijiji']
                         Father Bonifasi : ['Father Bonifasi']
                 Compasion International : ['Care International', 'Compasion International', 'Living Water International', 'Lotary International', 'Muslimehefen International', 'Plan International']
                               Tassaf Ii : ['Norad/ Tassaf Ii', 'Tasaf Ii', 'Tassaf I', 'Tassaf Ii', 'Tassaf/ Danida']
                                       F : []
                                   Msiki : ['Msiki', 'Msikiti']
                  Williamson Diamond Ltd : ['Williamson Diamond Ltd']
                                    Brad : ['Brad']
                         Concern/governm : ['Concern /govern', 'Concern/governm']
                                    Duka : ['Duka', 'Luka']
                         Morovian Church : ['Anglican Church', 'Lutheran Church', 'Methodist Church', 'Morovian Church', 'Roman Church']
                                   Cocen : ['Cocen', 'Cocern', 'Concen', 'Concern']
                              Halmashaur : ['Gra Na Halmashauri', 'Halimashau', 'Halimashauli', 'Halmashauli', 'Halmashaur', 'Halmashauri', 'Halmashauri Wil']
                                Mwaya Mn : ['Mwaya Mn']
               Dar Es Salaam Round Table : ['Dar Es Salaam Round Table']
                                   Socie : ['Socie']
                                   Aixos : ['Aixos']
                           Mwita Kichere : ['Mwita Kichere', 'Mwita Machota']
                Nyabibuye Islamic Center : ['Nyabibuye Islamic Center']
                    Fredked Conservation : ['Fredked Conservation', 'Friedkin Conservation Fund']
                              Wanakijiji : ['Wanakijiji']
                          Tarangire Park : ['Tarangire Park']
                                Stephano : ['Stephano', 'Stephano Paulo']
                                 Snv Ltd : ['Snv Ltd']
                                 Quwkwin : ['Quickwins', 'Quwkwin', 'Qwckwin', 'Qwekwin', 'Qwickwin']
                                Netherla : ['Natherland', 'Nethalan', 'Netherla', 'Netherland', 'Netherlands']
                            Dmdd/solider : ['Dmdd/solider']
                                  Unicef : ['Unice', 'Unicef', 'Uniceg', 'Unicet', 'Unicrf', 'Uniseg']
                                  Kanisa : ['Danida', 'Kajima', 'Kanis', 'Kanisa', 'Kanisani']
                                    Cmsr : ['Cmcr', 'Cmsr']
                                  Samwel : ['Samwel', 'Samweli']
                              Wame Mbiki : ['Wame Mbiki']
                                    Gain : ['Gain']
                                  Rwsssp : ['Rwssp', 'Rwssp/wsdp', 'Rwsssp']
                          Mnyamisi Jumaa : ['Mnyamisi Jumaa']
                         Villege Council : ['District Council', 'Village Communi', 'Village Community', 'Village Council', 'Villege Council']
                                   Acord : ['Acord']
                         Hydom Luthelani : ['Haydom Lutheran Hospital', 'Hydom Luthelani']
                                 Aic Kij : ['Aic Kij']
                                Unp/aict : ['Undp/aict', 'Unp/aict']
                                 Mkuluku : ['Mkuluku']
                                Sanje Wa : ['Sanje Wa']
                                     Urt : ['Urt']
                                Ded Kilo : ['Ded Kilo']
                         Tanzania /egypt : ['Tanzania /egypt', 'Tanzania Journey']
                        Cipro/government : ['China Government', 'Cipro/government', 'Danida /government', 'Egypt Government', 'Finland Government', 'Irish Government', 'Isf/government', 'Italy Government', 'Japan Government', 'Misri Government', 'Norad /government', 'Norad/government', 'Tcrs /government', 'Unhcr/government', 'Village Government']
                                 Piscope : ['Piscop', 'Piscope']
                       Government/school : ['Government /sda', 'Government /tassaf', 'Government/ World Bank', 'Government/school', 'Government/tassaf', 'Government/tcrs']
                            Regina Group : ['Regina Group']
                                 Ndolezi : ['Ndolezi']
            Friends Of Kibara Foundation : ['Friends Of Kibara Foundation']
                               Chamavita : ['Camavita', 'Chamavita', 'Chmavita']
                                   Islam : ['Islam', 'Islamic']
                                      Ru : ['Ru']
                          Ilkeri Village : ['Ilkeri Village']
                              Yasi Naini : ['Yasi Naini']
                                  Swifti : ['Swifti']
                                     Ngo : ['Ngo', 'Ngos']
                         Rajabu Athumani : ['Rajabu Athumani']
                                      Re : ['Re']
                         Dokta Mwandulam : ['Dokta Mwandulam']
                                      Rc : ['Rc']
                                  Dagida : ['Dagida', 'Daida', 'Danida', 'Dqnida']
                                      Ro : ['Ro']
                                   Idydc : ['Idydc']
                          Wirara Ya Maji : ['Idara Ya Maji', 'Wirara Ya Maji']
                                     Mgm : ['Mgm']
                                     Tbl : ['Tbl']
                           Tasaf And Lga : ['Tasaf And Lga', 'Tasaf And Mmem']
                                     Pad : ['Pad', 'Padi']
                    Member Of Parliament : ['Member Of Parliament', 'Member Of Perliament Ahmed Ali']
                                  Moradi : ['Mhoranzi', 'Morad', 'Moradi', 'Moravian', 'Norani']
                                  Abdala : ['Abdala']
                                   Seram : ['Seram', 'Serian']
                                  Un/wfp : ['Un/wfp']
                                  Piscop : ['Piscop', 'Piscope']
                                   Cipro : ['Cipro', 'Cpro']
                   Muslimu Society(shia) : ['Muslimu Society(shia)']
                  District Rural Project : ['District Rural Project', 'Domestic Water Supply Project']
                           Private Owned : ['Private Owned', 'Private Person']
                                    Dsdp : ['Asdp', 'Dadp', 'Drdp', 'Dsdp', 'Dwsdp', 'Wsdp']
                Government And Community : ['Government And Community', 'Government Of Tanzania', 'Government/ Community']
                                  Kahema : ['Kagera', 'Kahema', 'Kajima', 'Kamama', 'Mahemba']
                   Kiwanda Cha Tangawizi : ['Kiwanda Cha Ngozi', 'Kiwanda Cha Samaki', 'Kiwanda Cha Tangawizi']
                                Morovian : ['Moravian', 'Morovian', 'Morrovian']
                                    Cpro : ['Cipro', 'Cpro']
                                   Compa : ['Compa', 'Company']
                                   Eater : ['Eater', 'Water']
                           Doner And Ded : ['Doner And Com', 'Doner And Ded']
                                 Misheni : ['Misheni']
                  Regwa Company Of Egypt : ['Regwa Company Of Egpty', 'Regwa Company Of Egypt']
                        Water User Group : ['Water User As', 'Water User Group']
                  Grazie Franco Lucchini : ['Grazie Franco Lucchini']
                                Tassaf I : ['Tasaf 1', 'Tasaf Ii', 'Tassaf', 'Tassaf I', 'Tassaf Ii']
                              Waitaliano : ['Waitaliano']
                                    Sswp : ['Sswp']
                                     Tlc : ['Tlc', 'Tltc']
                         Cipro/care/tcrs : ['Cipro/care/tcrs']
                       Save The Rain Usa : ['Save The Rain Usa']
          Village Council/ Haydom Luther : ['Village Council/ Haydom Luther', 'Village Council/ Rose Kawala']
                                Kkkt Usa : ['Kkkt Canal', 'Kkkt Dme', 'Kkkt Usa']
                 Songea Municipal Counci : ['Kigoma Municipal Council', 'Sangea District Council', 'Songea District Council', 'Songea Municipal Counci', 'Tabora Municipal Council']
                                    Icdp : ['Icap', 'Icdp']
                           Peter Ngereka : ['Peter Ngereka']
                                  Mganga : ['Makanga', 'Mganga', 'Mwanza']
                                Makonder : ['Makonde', 'Makonder', 'Makundya']
                                    Iado : ['Iado', 'Nado', 'Tado']
                                     Apm : ['Apm']
                                   Esawa : ['Esawa', 'Gesawa', 'Hasawa', 'Hesawa']
                             Primo Zunda : ['Primo Zunda']
                                Selous G : ['Selous G']
                             Mwakabalula : ['Mwakabalula']
                           Japan Embassy : ['Japan Embassy', 'Usa Embassy']
                             Wug And Ded : ['Doner And Ded', 'Wua And Ded', 'Wug And Ded']
                                   Uaacc : ['Uaacc']
                                Medicine : ['Medicine']
                                     Lga : ['Lga']
                      Kiwanda Cha Samaki : ['Kiwanda Cha Ngozi', 'Kiwanda Cha Samaki', 'Kiwanda Cha Tangawizi']
                             Mchukwi Hos : ['Mchukwi Hos']
                                Minjingu : ['Minjingu']
                  Mfuko Wa Jimbo La Magu : ['Mfuko Wa Jimbo La Magu']
                               Rundu Man : ['Rundu Man', 'Runduman']
                                    Cspd : ['Cspd', 'Wspd']
                                 Ahmadia : ['Ahmadia', 'Chmavita']
                                  Kilimo : ['Kilimo']
                                     Ddp : ['Dadp', 'Ddp', 'Drdp', 'Dsdp']
                                  Redeso : ['Redeso']
                     Government Of Misri : ['Government /tassaf', 'Government /world Vision', 'Government And Community', 'Government Of Misri', 'Government Of Tanzania']
                                Oxfam Gb : ['Oxfam Gb', 'Oxfarm Gb']
                          Roman Cathoric : ['Rc Cathoric', 'Romam Catholic', 'Roman Catholic', 'Roman Cathoric', 'Roman Cathoric -kilomeni', 'Roman Cathoric Church', 'Roman Cathoric Same', 'Roman Cathoric-same', 'Roman Church']
                             Karadea Ngo : ['Kadres Ngo', 'Karadea Ngo']
                    School Adm9nstrarion : ['School Adm9nstrarion']
                                  Mwanza : ['Mganga', 'Mwanza']
          African Realief Committe Of Ku : ['African Realief Committe Of Ku']
                                   Ukida : ['Ukida']
                   Tingatinga Sec School : ['Longido Sec School', 'Tingatinga Sec School']
                                   Oikos : ['Oikos']
                                 Mnyambe : ['Mnyama', 'Mnyambe']
                                   Ruthe : ['Luthe', 'Ruthe']
                            Isnashia And : ['Isnashia And']
                                    Ccpk : ['Ccpk', 'Ccps']
                      Belgian Government : ['Belgian Government', 'British Colonial Government', 'China Government', 'Colonial Government', 'Danida /government', 'Egypt Government', 'Finland Government', 'Irish Government', 'Italy Government', 'Japan Government', 'Lwi & Central Government', 'Misri Government', 'Village Government', 'World Bank/government']
                                   Nethe : ['Nethe', 'Netherla']
                                Mikumi G : ['Mikumi G']
                                    Cdft : ['Cdft', 'Tdft']
                                   Oxfam : ['Oxfam', 'Oxfam Gb', 'Oxfarm']
                     Kilindi District Co : ['Kilindi District Co', 'Mkinga  Distric Cou', 'Mkinga Distric Coun']
                           Wamakapuchini : ['Makapuchini', 'Wamakapuchini']
                                 Sweeden : ['Sweden', 'Sweeden']
                                    Ccps : ['Ccpk', 'Ccps', 'Cpps']
                                      Do : ['Do']
                        Misri Government : ['Belgian Government', 'China Government', 'Cipro/government', 'Colonial Government', 'Danida /government', 'Egypt Government', 'Finland Government', 'Irish Government', 'Isf/government', 'Italy Government', 'Japan Government', 'Lwi & Central Government', 'Misri Government', 'Norad /government', 'Norad/government', 'Tcrs /government', 'Unhcr/government', 'Village Government']
                                      Dh : ['Dh']
                     Kagunguli Secondary : ['Kagunguli Secondary', 'Zingibali Secondary']
                                      De : ['De']
                          Tassaf/ Danida : ['Tassaf/ Danida']
                                   Tz As : ['Tz As']
                       Gerald Tuseko Gro : ['Gerald Tuseko Gro']
                                      Dv : ['Dv']
                                      Dw : ['Dw']
                                   Kadip : ['Kadip', 'Kadp']
                                Investor : ['Investor']
                             Simba Lodge : ['Simba Lodge']
                         Ambwene Mwaikek : ['Ambwene Mwaikek']
                                Bokera W : ['Bokera W']
                                 Mungaya : ['Mungaya']
                                   Samlo : ['Samlo']
                              Mzee Omari : ['Mbwana Omari', 'Mzee Omari', 'Mzee Smith', 'Said Omari']
                                    Ifad : ['Ifad']
                                   Healt : ['Healt']
                                   Denat : ['Denat']
                   Tlc/seleman Mang'ombe : ["Tlc/seleman Mang'ombe"]
                                 Lions C : ['Lion Clu', 'Lions C', 'Lions Club']
                             Ester Ndege : ['Ester Ndege']
                                 Paskali : ['Pankrasi', 'Paskali']
                                    Soda : ['Sida', 'Soda']
                 Magadini Makiwaru Water : ['Magadini Makiwaru Water', 'Magadini-makiwaru Water']
                                   Mdgwc : ['Mdgwc']
                                Nyangere : ['Nyangere']
                                Mzinga A : ['Mzinga A']
                           Doctor Mwambi : ['Doctor Mwambi']
                                   Tadeo : ['Tadeo', 'Tadepa', 'Tado', 'Tareto']
                      Revocatus Mahatane : ['Revocatus Mahatane']
                 Haidomu Lutheran Church : ['Haidomu Lutheran Church', 'Haydom Lutheran Hospital']
                                   Jeica : ['Jaica', 'Jeica', 'Jica']
                              Mwingereza : ['Magereza', 'Mwingereza']
                                  Concen : ['Cocen', 'Cocern', 'Conce', 'Concen', 'Concern']
                                  Missio : ['Missi', 'Missio', 'Mission', 'Missionary', 'Rc Mission']
                            Sophia Wazir : ['Sophia Wazir']
                  Dae Yeol And Chae Lynn : ['Dae Yeol And Chae Lynn']
                              Tlc/samora : ['Tlc/samora']
                                 Enyueti : ['Enyuati', 'Enyueti']
                                  Stabex : ['Stabex']
                                     Icf : ['Icf']
                                       H : []
                       Wafidhi Wa Ziwa T : ['Wafidhi Wa Ziwa T']
                                  Danida : ['Canada', 'Dagida', 'Daida', 'Danida', 'Dqnida', 'Kanisa']
                                W.D.&.I. : ['W.D & I.', 'W.D.&.I.']
                               Undp/aict : ['Undp/aict', 'Undp/ilo', 'Unp/aict']
                              Aic Church : ['Agt Church', 'Aic Church', 'Anglican Church', 'Baptist Church', 'Batist Church', 'Fpct Church', 'Kkkt Church', 'Pag Church', 'Rc Churc', 'Rc Church', 'Roman Church', 'Sda Church', 'Tag Church']
                                   Villa : ['Bilila', 'Villa', 'Villaers', 'Village', 'Villages']
                                   Tahea : ['Kahema', 'Tabea', 'Tadepa', 'Tahea']
                         Motiba Manyanya : ['Motiba Manyanya', 'Motiba Wambura']
                                  Denish : ['Denish']
                         Mwalimu Muhenza : ['Mwalimu Muhenza']
                           Chacha Issame : ['Chacha Issame']
                Kanisa Katoliki Lolovoni : ['Kanisa Katoliki Lolovoni']
                                   Mtewe : ['Mtewe']
                                   Tardo : ['Tado', 'Tardo', 'Tareto', 'Tirdo']
                       Hilfe Fur Brunder : ['Hilfe Fur Brunder']
                                  Wahidi : ['Wahidi']
                                   Ringo : ['Ringo']
                   Halmashauri Ya Wilaya : ['Halmashauri Wil', 'Halmashauri Ya Manispa Tabora', 'Halmashauri Ya Wilaya', 'Halmashauri Ya Wilaya Sikonge']
                                 Grumeti : ['Grumeti']
                                   B.A.P : ['B.A.P']
                              Seif Ndago : ['Seif Ndago']
                                Kilomber : ['Kilomber', 'Kilwater']
                                Undp/ilo : ['Undp/aict', 'Undp/ilo']
                                   Folac : ['Folac']
                                     Awf : ['Awf']
                                     Dct : ['Dct']
                                     Ndm : ['Ndm']
                     Mkinga  Distric Cou : ['Kilindi District Co', 'Mheza Distric Counc', 'Mkinga  Distric Cou', 'Mkinga Distric Coun', 'Sangea District Council', 'Songea District Council']
                                     Krp : ['Krp']
                          Theonas Mnyama : ['Teresa Munyama', 'Theonas Mnyama']
                    Tlc/nyengesa Masanja : ['Tlc/nyengesa Masanja']
                                   Padep : ['Padep', 'Tadepa']
                                  Dassip : ['Dasiip', 'Dasip', 'Dassip', 'Kassim']
                        Bathlomew Vicent : ['Bathlomew Vicent']
                            Kizego Jumaa : ['Kizego Jumaa']
                                     Pmo : ['Pmo']
                                    Rwsp : ['Dwsp', 'Rssp', 'Rwsp', 'Rwssp', 'Rwsssp']
                      Tulawaka Gold Mine : ['Bulyahunlu Gold Mine', 'Tulawaka Gold Mine']
                                       C : []
                                    Kwik : ['Kwik']
                          Seleman Masoud : ['Seleman Masoud', 'Seleman Rashid']
                                   Rotte : ['Rotte']
                                Wateraid : ['Natherland', 'Water Board', 'Water Se', 'Wateraid']
              The Desk And Chair Foundat : ['Desk And Chair Foundation', 'The Desk And Chair Foundat']
                          Private Person : ['Private Person']
                     Tlc/emmanuel Kasoga : ['Tlc/emmanuel Kasoga']
                        Luke Samaras Ltd : ['Luke Samaras Ltd']
                      Chama Cha Ushirika : ['Chama Cha Ushirika']
                                 Kashwas : ['Kashwas']
                       St Magreth Church : ['Nazareth Church', 'St Magreth Church']
                                     Dwt : ['Dwst', 'Dwt']
                         Shule Ya Msingi : ['Shule Ya Msingi', 'Shule Ya Msingi Ufala']
                  Issa Mohamedi Tumwanga : ['Issa Mohamedi Tumwanga']
                              Wsdp & Sdg : ['Wsdp & Sdg']
                                 Ukiligu : ['Ukiligu']
                    Scharnhorstgymnasium : ['Scharnhorstgymnasium']
                                     Dmd : ['Dmd', 'Dmdd', 'Dmmd']
                                     Dmk : ['Dmk']
                                  Rotary : ['Rotary', 'Rotary I', 'Rotery C']
                                     Dmo : ['Dmo']
                                  Hewawa : ['Gesawa', 'Hasawa', 'Hesawa', 'Hesawwa', 'Hesawz', 'Hesawza', 'Hesswa', 'Hewasa', 'Hewawa', 'Hhesawa']
                                Finwater : ['Fin Water', 'Fini Water', 'Finn Water', 'Finwater', 'Fiwater', 'Kiliwater', 'Kilwater']
                                Makundya : ['Makonder', 'Makundya']
                           Afriican Reli : ['African Relie', 'Afriican Reli']
                                  Tadepa : ['Tadepa', 'Tanapa']
                            Sindida Yetu : ['Silinda Yetu', 'Sindida Yetu', 'Singida Yetu']
                                     Kdc : ['Kdc']
                       Germany Cristians : ['Germany Cristians', 'Germany Misionary', 'Germany Missionary']
                         Mwamvita Rajabu : ['Mwamvita Rajabu']
                                    Lcgd : ['Lcgd', 'Ldcgd', 'Lgcgd']
                  Mbozi District Council : ['Cdtfdistrict Council', 'District Council', 'Mbozi District Council', 'Mheza Distric Counc', 'Sangea District Council', 'Sengerema District Council', 'Songea District Council', 'Wb / District Council']
           Professor Ben Ohio University : ['Professor Ben Ohio University']
          Oak'zion' And Bugango B' Commu : ["Oak'zion' And Bugango B' Commu"]
                                  Peters : ['Peter', 'Peters']
                             Halmashauli : ['Gra Na Halmashauri', 'Halimashau', 'Halimashauli', 'Halmashauli', 'Halmashaur', 'Halmashauri', 'Halmashauri Wil']
                      Magu Food Security : ['Magu Food Security']
                          Romam Catholic : ['Romam Catholic', 'Roman Catholic', 'Roman Cathoric', 'Roman Cathoric Church', 'Roman Cathoric Same', 'Roman Cathoric-same']
                                     Hpa : ['Hapa', 'Hpa']
                Makonde Water Population : ['Makondakonde Water Population', 'Makonde Water Population', 'Makonde Water Supply']
                                   Mbeje : ['Mbeje']
                                  Nassan : ['Nasan', 'Nassan', 'Tassaf']
                                 Kwikwiz : ['Kwikwiz', 'Qwickwin']
                             Mzungu Paul : ['Mzungu Paul']
                                 Mkulima : ['Mkulima']
                                 Masista : ['Mahita', 'Masista']
                                 Caritas : ['Caltas', 'Caritas', 'Kalitasi']
                         Nyamuhanga Maro : ['Nyamuhanga Maro']
                      World Vision/ Kkkt : ['World Vision/ Kkkt', 'World Vision/adra', 'World Vision/rc Church']
                                 Vickfis : ['Vicfish', 'Vickfis']
                            Afroz Ismail : ['Afroz Ismail']
                   Lake Tanganyika Basin : ['Lake Tanganyika', 'Lake Tanganyika Basin', 'Lake Tanganyika Prodap']
                            Cpps Mission : ['Cpps Mission', 'Heri Mission', 'Neemia Mission', 'Rc Mission']
                                    Dasp : ['Dacp', 'Dadp', 'Dasiip', 'Dasip', 'Dasp', 'Dassip', 'Dbsp', 'Dwsp']
                                      Is : ['Is']
                                      Ir : ['Ir']
                              Isf/tacare : ['Isf/tacare', 'Msf/tacare']
                             Fpct Mulala : ['Fpct Mulala']
                           Rcchurch/cefa : ['Rc Church/centr', 'Rcchurch/cefa']
                                      In : ['In']
                             Paulo Sange : ['Paulo Sange']
                                     Cgc : ['Cgc']
                                      If : ['If']
                                     Mws : ['Mws']
                                   Missi : ['Missi', 'Missio', 'Mission', 'Rc Missi']
               Hearts Helping Hands.Inc. : ['Hearts Helping Hands.Inc.']
                  Government Of Tanzania : ['Government And Community', 'Government Of Misri', 'Government Of Tanzania', 'Government/ World Bank']
                          San Pellegrino : ['San Pellegrino']
                                   Patuu : ['Patuu']
                              Parastatal : ['Parastatal', 'Parastatal An']
                                   Lions : ['Lions', 'Lions C']
                                 Sauwasa : ['Auwasa', 'Bahewasa', 'Dawasa', 'Kuwasa', 'Liuwassa', 'Mbiuwasa', 'Mtuwasa', 'Muwasa', 'Sauwasa', 'Sawaka', 'Shawasa', 'Sowasa', 'Suwasa', 'Tuwasa']
                             Kingupira S : ['Kingupira S']
                Village Water Commission : ['Village Water Commission']
                                  Dqnida : ['Dagida', 'Danida', 'Dqnida']
                                   Males : ['Malec', 'Males', 'Masese']
                         Said Salum Ally : ['Said Salum Ally']
                                   Othod : ['Othod']
                               John Fund : ['Jimbo Fund', 'John Fund']
                                 Noshadi : ['Noshad', 'Noshadi']
                               Ms-danish : ['Ms-danish']
                            Unhcr/danida : ['Unhcr/danida']
             Resolute Mininggolden Pride : ['Resolute Mininggolden Pride']
                                  Mitema : ['Mitema']
                          European Union : ['European Union']
                               Not Known : ['Not Known']
                          Robert Kampala : ['Robert Kampala', 'Robert Loyal']
                                   H4ccp : ['H4ccp']
            Japan  Food Aid Counter Part : ['Japan  Food Aid Counter Part']
                             Lwiji Italy : ['Lwiji Italy']
          Grazie Grouppo Padre Fiorentin : ['Grazie Grouppo Padre Fiorentin']
          Oikos E .Africa/european Union : ['Oikos E .Africa/european Union', 'Oikos E.Africa/ European Union', 'Oikos E.Africa/european Union']
                                    Maro : ['Maro', 'Mataro', 'Mayiro']
                           Mzee Lesilali : ['Mzee Lesilali']
                                Udc/sema : ['Udc/sema']
                                    Tgts : ['Tgrs', 'Tgts']
                                 Sakwidi : ['Sakwidi']
                 Ministry Of Agricultura : ['Ministry Of Agricultura', 'Ministry Of Education']
                              Government : ['Belgian Government', 'China Government', 'Cipro/government', 'Egypt Government', 'Finland Government', 'Government', 'Government /sda', 'Government /tassaf', 'Government/school', 'Government/tassaf', 'Government/tcrs', 'Irish Government', 'Isf/government', 'Italy Government', 'Japan Government', 'Misri Government', 'Norad/government', 'Overnment', 'Tcrs /government', 'Unhcr/government', 'Vgovernment', 'Village Government']
                                     Mem : ['Mem', 'Mmem']
                                     Iom : ['Iom']
                                    Wcst : ['Wcst']
                             Norad/japan : ['Norad/ Tassaf', 'Norad/japan']
                   African Muslim Agency : ['African Muslim Agency', 'Unicef/african Muslim Agency']
                                   Dioce : ['Dioce']
                          Teresa Munyama : ['Teresa Munyama', 'Theonas Mnyama']
                                   Dwsdp : ['Drwssp', 'Dsdp', 'Dwsdp', 'Dwsp', 'Dwssp']
                            Padri Matayo : ['Padri Matayo']
                                    Jika : ['Jica', 'Jika', 'Jipa']
                            Kambi Migoko : ['Kambi Migoko']
                                  Panone : ['Panone']
                                   Latfu : ['Latfu']
          African Reflections Foundation : ['African Development Foundation', 'African Reflections Foundation']
                      Government /tassaf : ['Government /sda', 'Government /tassaf', 'Government /world Vision', 'Government Of Misri', 'Government Of Tanzania', 'Government/ World Bank', 'Government/school', 'Government/tassaf', 'Government/tcrs']
                               Red Cross : ['Red Cross', 'Redcross']
                                      Nk : ['Nk']
                            Lottery Club : ['Lotary Club', 'Lottery Club', 'Rotary Club', 'Rotaty Club']
                                     Adp : ['Adap', 'Adp', 'Afdp', 'Asdp']
                                      No : ['No']
                                     Adf : ['Adf']
                                     Lwi : ['Lwi']
                                     Adb : ['Adb']
                                     Lwf : ['Lwf']
                          Community Bank : ['Community Bank']
                                    Cpps : ['Ccps', 'Cpps']
            Kitiangare Village Community : ['Buluga Subvillage Community', 'Kitiangare Village Community', 'Ngiresi Village Community', 'Okutu Village Community', 'Oldadai Village Community', 'Olgilai Village Community', 'Sekei Village Community']
                           Justine Marwa : ['Justine Marwa', 'Selestine Mganga']
                                Camavita : ['Camavita', 'Chamavita', 'Chmavita']
                           Doner And Com : ['Doner And Com', 'Doner And Ded']
                   Rotary Club Kitchener : ['Rotary Club Australia', 'Rotary Club Kitchener']
                            Singida Yetu : ['Silinda Yetu', 'Sindida Yetu', 'Singida Yetu']
                    Rilayo Water Project : ['Kindoroko Water Project', 'Rilayo Water Project']
                                Seronera : ['Seronera']
                        Ten Degree Hotel : ['Ten Degree Hotel']
                                  Tareto : ['Tareto', 'Warento']
                            Maajabu Pima : ['Maajabu Pima']
                                Goldmain : ['Geita Goldmain', 'Goldmain']
                                  Caltas : ['Caltas', 'Caltus', 'Caritas', 'Kalitasi']
                                   Simav : ['Simav', 'Simavi']
             Abc-ihushi Development Cent : ['Abc-ihushi Development Cent', 'African Development Bank']
                                Ded_rwsp : ['Ded/rwssp', 'Ded_rwsp']
                         Muhochi Kissaka : ['Muhochi Kissaka']
                                    Twig : ['Twig']
                             Rc Cathoric : ['Cathoric', 'Rc Cathoric', 'Romam Catholic', 'Roman Catholic', 'Roman Cathoric']
                        Norad/ Tassaf Ii : ['Norad/ Tassaf', 'Norad/ Tassaf Ii']
                              Kkkt Mareu : ['Kkkt Canal', 'Kkkt Mareu']
                               Omar Ally : ['Omar Ally']
                                  Magani : ['Magani']
                                   Donor : ['Donor']
                            Village Govt : ['Village Communi', 'Village Community', 'Village Council', 'Village Fund', 'Village Government', 'Village Govt', 'Village Office', 'Village Res']
                       Aqua Blues Angels : ['Aqua Blues Angels']
                         Secondary Schoo : ['Mbozi Secondary School', 'Secondary Schoo']
                                    Chuo : ['Chuo']
                                   Nasan : ['Nasan', 'Nassan']
                                    Sumo : ['Sumo']
                                   Bened : ['Bened']
                         Rwssp Shinyanga : ['Rwssp Shinyanga']
                    Scholastica Pankrasi : ['Scholastica Pankrasi']
                          Oikos E.Afrika : ['Oikos E.Afrika']
                                  Kidika : ['Kidika']
                        Timothy Shindika : ['Timothy Shindika']
           Makondakonde Water Population : ['Makondakonde Water Population', 'Makonde Water Population']
                                  Qwiqwi : ['Qwickwin', 'Qwiqwi']
                           Totoland Care : ['Total Land Care', 'Total Landcare', 'Totaland Care', 'Totoland Care']
                           Cefa/rcchurch : ['Cefa/rcchurch']
                                     Bra : ['Bra', 'Brad']
                                  Canada : ['Canada', 'Canada Aid', 'Danida', 'Tanapa']
                           Misana George : ['Misana George']
                       Quick Wins Scheme : ['Quick Win Project', 'Quick Wins Scheme']
                                    Cbhi : ['Cbhi']
                           Kkkt Leguruki : ['Kkkt Leguruki']
                       Moslem Foundation : ['Bingo Foundation', 'Goldwill Foundation', 'Kibara Foundation', 'Kombe Foundation', 'Kuji Foundation', 'Moslem Foundation']
                             Shamte Said : ['Shamte Said']
                                   Brown : ['Brown']
                                  Holand : ['Holand', 'Holland', 'Totoland']
                                   Swash : ['Sowasa', 'Suwasa', 'Swash']
                                   Natio : ['Natio']
                              Japan Food : ['Japan Aid', 'Japan Food', 'Japan Food Aid']
                     The People Of Japan : ['People Of Japan', 'The People Of Japan']
                          Nazalet Church : ['Baptist Church', 'Batist Church', 'Nazalet Church', 'Nazareth Church', 'St Magreth Church']
                           Batist Church : ['Baptist Church', 'Batist Church', 'Methodist Church', 'Nazalet Church', 'Nazareth Church', 'Pentecosta Church', 'Pentecostal Church']
                               Villegers : ['Villaers', 'Village Res', 'Villagers', 'Villagers Mpi', 'Villages', 'Villegers']
                               Msikitini : ['Msikiti', 'Msikiti Masji', 'Msikitini']
                                  Bumabu : ['Bumabu']
                         Rashid Mahongwe : ['Rashid Mahongwe']
                   Rotary Club Australia : ['Rotary Club Australia', 'Rotary Club Kitchener']
                                   W.C.S : ['W.C.S']
                                    Ngos : ['Ngos']
                                   Arabi : ['Arabi']
                                   Kigwa : ['Kigwa', 'Msigwa']
                                   Dbfpe : ['Dbfpe', 'Dbspe']
                                   Cafod : ['Cafod']
                       Nimrodi Mkono[mb] : ['Nimrodi Mkono[mb]']
                             Moshono Adp : ['Moshono Adp']
                                     Dsp : ['Dasp', 'Dbsp', 'Dsdp', 'Dsp', 'Dwsp']
                                  Abddwe : ['Abddwe']
                             Village Res : ['Village Fund', 'Village Govt', 'Village Office', 'Village Res', 'Villagers', 'Villagers Mpi', 'Villages']
                              Dar Al Ber : ['Dar Al Ber']
                       Igolola Community : ['Igolola Community', 'Ilwilo Community', 'Islamic Community', 'Marumbo Community', 'Maseka Community', 'Olgilai Village Community', 'Tcrs/village Community', 'Village Community']
                                   Korea : ['Korea']
                              Nyitamboka : ['Nyitamboka']
                          Isf/government : ['China Government', 'Cipro/government', 'Danida /government', 'Egypt Government', 'Irish Government', 'Isf/government', 'Italy Government', 'Japan Government', 'Misri Government', 'Norad /government', 'Norad/government', 'Tcrs /government', 'Unhcr/government', 'Vgovernment', 'Village Government']
                                    Opec : ['Opec']
                                Kanisani : ['Kalitasi', 'Kanisa', 'Kanisani']
                                   Rudri : ['Rodri', 'Rudri']
                         Rc Church/centr : ['Rc Church/centr', 'Rcchurch/cefa']
                        Watu Wa Marekani : ['Dwe/ubalozi Wa Marekani', 'Ubalozi Wa Marekani', 'Watu Wa Marekani', 'Watu Wa Ujerumani']
                                       K : []
                                 Finland : ['Finland']
                                  Kinapa : ['Kinapa', 'Senapa', 'Tanapa']
           Domestic Water Supply Project : ['Domestic Water Supply Project']
                          Arab Community : ['Arab Community', 'Arabs Community', 'Igolola Community', 'Ilwilo Community', 'Islamic Community', 'Marumbo Community', 'Maseka Community', 'Tcrs/village Community', 'Village Community']
                            Tquick Wings : ['Quick Wings', 'Quick Wins', 'Tquick Wings']
                              Masai Land : ['Masai Land']
                         Kuji Foundation : ['Bingo Foundation', 'Goldwill Foundation', 'Kibara Foundation', 'Kombe Foundation', 'Kuji Foundation', 'Moslem Foundation']
                                  Bilila : ['Bilila']
                                     Wua : ['Wua']
                                Rc Njoro : ['Rc Njoro']
                                Soliderm : ['Solidame', 'Solidarm', 'Soliderm']
                                       W : []
                                    Rada : ['Rada']
                    Pori La Akiba Kigosi : ['Pori La Akiba Kigosi']
                                  Kuwait : ['Kuwait', 'Kuwasa']
                                  Tancan : ['Tancan', 'Tancro', 'Tanzania']
                                     Tom : ['Tom']
                           Owner Pingo C : ['Owner Pingo C']
                                     Tgt : ['Tgt', 'Tgts']
                          Nipon & Panoco : ['Nipon & Panoco']
                                  Doddea : ['Doddea']
                                    Sijm : ['Sijm']
                Shule Ya Sekondari Ipuli : ['Shule Ya Sekondari Ipuli']
                            Shear Muslim : ['Shear Muslim']
                             Unicef/ Csp : ['Unice/ Cspd', 'Unicef/ Csp', 'Unicef/cspd']
                                  Vifafi : ['Vifaf', 'Vifafi', 'Vififi']
                                      Sw : ['Sw']
                                      St : ['St']
                                      Si : ['Si']
                                   Priva : ['Priva', 'Private']
                                  Taasaf : ['Taasaf', 'Tasaf', 'Tasafu', 'Tassaf', 'Tassaf I']
                                   Twesa : ['Tuwasa', 'Twesa']
                           Ardhi Instute : ['Ardhi Instute']
                         Zaburi And Neig : ['Zaburi And Neig']
                             Tag Patmo's : ["Tag Patmo's"]
                                    Dbsp : ['Dasp', 'Dbsp', 'Dbspe', 'Dwsp']
                             Maju Mugumu : ['Maji Mugumu', 'Maju Mugumu']
                                     Mdc : ['Mdc']
                                   Dasip : ['Dasiip', 'Dasip', 'Dasp', 'Dassip']
                                   Cg/rc : ['Cg/rc']
                          Muslim Society : ['Islamic Society', 'Muslim Society', 'Muslimu Society(shia)']
                             Pentecostal : ['Pentecost', 'Pentecosta Church', 'Pentecosta Seela', 'Pentecostal', 'Pentecostal Church', 'Pentekoste']
                                  Mnyama : ['Mnyama', 'Mnyambe']
                               Quick Win : ['Quick Win', 'Quick Wings', 'Quick Wins', 'Quickwins', 'Qwick Win', 'Qwickwin', 'Tquick Wings']
                                    Cper : ['Cpar', 'Cper']
                                Plan Int : ['Plan Int']
                                    Cida : ['Cida', 'Fida', 'Sida']
                       Government/tassaf : ['Government /sda', 'Government /tassaf', 'Government Of Misri', 'Government Of Tanzania', 'Government/ World Bank', 'Government/school', 'Government/tassaf', 'Government/tcrs']
                                Matyenye : ['Matyenye']
                            Insututional : ['Insititutiona', 'Institution', 'Institutional', 'Insututional']
                                  Kirdep : ['Kidep', 'Kirde', 'Kirdep']
                                    Ddca : ['Ddca']
                                     Bsf : ['Bsf']
           Rural Water Supply And Sanita : ['Rural Water Supply And Sanita', 'Rural Water Supply And Sanitat']
                                    Fpct : ['Fpct']
             Buluga Subvillage Community : ['Buluga Subvillage Community', 'Kitiangare Village Community', 'Ngiresi Village Community', 'Okutu Village Community', 'Oldadai Village Community', 'Olgilai Village Community', 'Sekei Village Community', 'Tcrs/village Community']
                                     Dom : ['Dom']
                       Dwe/bamboo Projec : ['Dwe/bamboo Projec']
                          Rarymond Ekura : ['Rarymond Ekura']
                                  Bgssws : ['Bgssws']
                              Agt Church : ['Agape Churc', 'Agt Church', 'Aic Church', 'Anglican Church', 'Baptist Church', 'Batist Church', 'Fpct Church', 'Kkkt Church', 'Nazalet Church', 'Pag Church', 'Rc Church', 'Roman Church', 'Sda Church', 'Tag Church']
                                    Lisa : ['Lisa', 'Sisa']
                   Wb / District Council : ['Cdtfdistrict Council', 'District Council', 'Mbozi District Council', 'Mheza Distric Counc', 'Sangea District Council', 'Sengerema District Council', 'Songea District Council', 'Wb / District Council']
                                   Commu : ['Commu']
                                     Kfw : ['Kfw']
                                 Konoike : ['Konoike']
                                    Dmmd : ['Dmdd', 'Dmmd']
                                   Ereto : ['Ereto', 'Tareto']
                                    Filo : ['Filo']
                           Ruvu Darajani : ['Ruvu Darajani']
                                  Mahita : ['Mahita', 'Masista']
                S.P.C Pre-primary School : ['Luchelegu Primary School', 'S.P.C Pre-primary School']
                               Morrovian : ['Moravian', 'Morovian', 'Morrovian']
                             Kagera Mine : ['Kagera Mine']
                      One Desk One Chair : ['One Desk One Chair', 'The Desk And Chair Foundat']
                                 Samweli : ['Samwel', 'Samweli']
                          Village Office : ['Village Council', 'Village Office']
                       Islamic Community : ['Arab Community', 'Arabs Community', 'Igolola Community', 'Ilwilo Community', 'Islamic Community', 'Islamic Society', 'Marumbo Community', 'Maseka Community', 'Tcrs/village Community', 'Village Community']
                                 Marafip : ['Marafin', 'Marafip']
                      Longido Sec School : ['Longido Sec School', 'Poland Sec School', 'Tingatinga Sec School']
                                  Chacha : ['Chacha']
                      Kanisa La Menonite : ['Kanisa La Menonite', 'Kanisa La Mitume']
                        Kanisa La Mitume : ['Kanisa La Menonite', 'Kanisa La Mitume', 'Kanisa La Neema']
                                   Msigw : ['Msigw', 'Msigwa']
                                 Marafin : ['Marafin', 'Marafip', 'Moravian']
                                       L : []
                                  Yasini : ['Yasi Naini', 'Yasini']
                           Africaone Ltd : ['Africaone Ltd']
                            Tcrs Kibondo : ['Tcrs Kibondo']
                                     Bao : ['Balo', 'Bao']
                 Mzee Salum Bakari Darus : ['Mzee Salum Bakari Darus']
                          Water Aid/sema : ['Wate Aid/sema', 'Water /sema', 'Water Aid /sema', 'Water Aid/dwe', 'Water Aid/sema']
             Finida German Tanzania Govt : ['Finida German Tanzania Govt', 'Finidagermantanzania Govt']
                               Maxavella : ['Maxavella']
                                 Samsoni : ['Samsoni']
                                     Ras : ['Ras']
                                 Council : ['Council', 'Town Council']
                       Quick Win Project : ['Quick Win Project', 'Quick Win Project /council', 'Quick Wins Scheme']
                        People Of Sweden : ['People Of Japan', 'People Of Sweden']
                Lwi & Central Government : ['British Colonial Government', 'Lwi & Central Government']
                           Kyela Council : ['Kyela Council', 'Town Council', 'Village Council', 'Villege Council']
                                    Cocu : ['Cocu']
                          Mama Mery Nagu : ['Mama Mery Nagu']
                        Maseka Community : ['Arab Community', 'Arabs Community', 'Igolola Community', 'Ilwilo Community', 'Islamic Community', 'Marumbo Community', 'Maseka Community', 'Mtuwasa And Community', 'Tcrs/village Community', 'Village Community']
                     Hasnein Muij Mbunge : ['Hasnan Murig (mbunge)', 'Hasnein Muij Mbunge']
                                     Eno : ['Eno']
                          Mbozi Hospital : ['Mbozi Hospital']
                           Ngelepo Group : ['Ngelepo Group']
                        Mzee Yassin Naya : ['Mzee Yassin Naya']
                        Kwasenenge Group : ['Kwasenenge Group']
                                   Redep : ['Redap', 'Redep', 'Redeso', 'Redet', 'Ridep', 'Rudep', 'Tredep']
                                   Redet : ['Redep', 'Redeso', 'Redet']
                                Dhv\norp : ['Dhv Moro', 'Dhv\\norp']
                                   Wanan : ['Tancan', 'Wanan', 'Wananchi']
                    Private Institutions : ['Private Institutions']
                            Tanga Cement : ['Tanga Cement']
                               Tanzaling : ['Tanzaling', 'Tanzania']
                                    None : ['None']
                            Heri Mission : ['Cpps Mission', 'German Missionary', 'Germany Missionary', 'Heri Mission', 'Neemia Mission', 'Rc Mission']
                                 Mzee Sh : ['Mzee Don', 'Mzee Sh', 'Mzee Smith']
                               Oxfarm Gb : ['Oxfam Gb', 'Oxfarm Gb']
                                    Cdcg : ['Cdcg']
                                   Chani : ['Chani', 'Cheni']
                   Mamlaka Ya Maji Ngara : ['Mamlaka Ya Maji Ngara']
                            Bridge North : ['Bridge North']
          Rotary Club Of Chico And Moshi : ['Rotary Club Of Chico And Moshi', 'Rotary Club Of Usa And Moshi']
                      Kilimarondo Parish : ['Kilimarondo Parish', 'Loliondo Parish']
                                      El : ['El']
                                 Partage : ['Partage']
                                      Ea : ['Ea']
                                  Tanapa : ['Canada', 'Kinapa', 'Senapa', 'Tadepa', 'Tanap', 'Tanapa', 'Tanzania']
                                   Kurrp : ['Kurrp', 'Kurrp Ki']
                                  Simone : ['Simone']
                Eung-am Methodist Church : ['Eung Am Methodist Church', 'Eung-am Methodist Church']
                                    Haam : ['Haam']
                                      Eu : ['Eu']
                                 Aimgold : ['Aimgold']
                                   Njula : ['Njula']
          Member Of Perliament Ahmed Ali : ['Member Of Perliament Ahmed Ali']
                                     Imf : ['Imf']
                                  Sabodo : ['Sabemo', 'Sabodo', 'Sobodo']
                                Liuwassa : ['Liuwassa', 'Mbiuwasa']
                             Omar Rafael : ['Omar Rafael']
                                    Wspd : ['Cspd', 'Wspd']
                                   Ruped : ['Ruped']
                                  Moroil : ['Moroil', 'Morovian']
                                    D Ct : ['D Ct']
                                 Mashaka : ['Mashaka']
                            Judge Mchome : ['Judge Mchome']
                                   Fabia : ['Fabia']
                                   Boazi : ['Boazi', 'Boazi /o']
                             Team Rafiki : ['Team Rafiki']
                                 Babtest : ['Babtest', 'Babtist']
                                   Vwcvc : ['Vwcvc', 'Vwcvwc']
                                 Olumuro : ['Olumuro']
                               Millenium : ['Millenium']
                                  Waheke : ['Waheke']
                           Parastatal An : ['Parastatal', 'Parastatal An']
                                     Wfp : ['Wfp']
                              Halimashau : ['Halimashau', 'Halimashauli', 'Halmashauli', 'Halmashaur', 'Halmashauri']
                              World Bank : ['World Bank']
                          Stephano Paulo : ['Stephano Paulo']
                              Rudep /dwe : ['Rudep /dwe']
                    Bulyahunlu Gold Mine : ['Bulyahunlu Gold Mine', 'Tulawaka Gold Mine']
                                   Tasef : ['Taasaf', 'Tasaf', 'Tasafu', 'Tasef', 'Tasf', 'Tassaf']
                           Nyakaho Mwita : ['Nyakaho Mwita']
                         Anglican Church : ['Anglican Church', 'Dwe/anglican Church', 'Lutheran Church', 'Morovian Church']
                                Rotary I : ['Rotary', 'Rotary Club', 'Rotary I', 'Rotery C']
                Africa 2000 Network/undp : ['Africa 2000 Network/undp', 'African 2000 Network']
                            Maro Kyariga : ['Maro Kyariga']
                                   Jumaa : ['Juma', 'Jumaa']
                              Stansilaus : ['Stansilaus']
                                  Saudia : ['Saudia']
                                     Dhv : ['Dhv']
                                Floresta : ['Floresta']
                           Siter Fransis : ['Sister Francis', 'Siter Fransis']
          Free Pentecoste Church Of Tanz : ['Free Pentecoste Church Of Tanz']
             Rural Drinking Water Supply : ['Rural Drinking Water Supply']
                                 Germany : ['A/co Germany', 'Germany']
                       Tlc/jenus Malecha : ['Tlc/jenus Malecha', 'Tlc/nyengesa Masanja']
                                 Hongoli : ['Chongolo', 'Hongoli']
                           Mzee Mkungata : ['Mzee Mkungata']
                                       M : []
                                Act Mara : ['Act Mara']
                                   Tanza : ['Mwanza', 'Tanapa', 'Tancan', 'Tanza', 'Tanzania']
                                     Isf : ['Isf']
                        Norad/government : ['Belgian Government', 'China Government', 'Cipro/government', 'Colonial Government', 'Danida /government', 'Egypt Government', 'Finland Government', 'Irish Government', 'Isf/government', 'Italy Government', 'Japan Government', 'Misri Government', 'Norad /government', 'Norad/government', 'Tcrs /government', 'Unhcr/government', 'Village Government', 'World Bank/government']
                          Moyowosi Basin : ['Moyowosi Basin']
                                    Bffs : ['Bffs']
                                   Egypt : ['Egypt']
                    Losakia Water Supply : ['Holili Water Supply', 'Lawate Fuka Water Suppl', 'Lawatefuka Water Supply', 'Losaa-kia Water Supply', 'Losakia Water Supply', 'Makonde Water Supply', 'Rural Drinking Water Supply', 'Rural Water Supply']
                           Totaland Care : ['Total Land Care', 'Total Landcare', 'Totaland Care', 'Totoland Care']
                                Dhv/gove : ['Dhv/gove']
                              Rc Mission : ['Cpps Mission', 'Heri Mission', 'Neemia Mission', 'Rc Missi', 'Rc Mission', 'Rc Missionary', 'Rc/mission']
                           Norad/ Tassaf : ['Norad/ Tassaf', 'Norad/ Tassaf Ii']
                Kigoma Municipal Council : ['Kigoma Municipal Council', 'Municipal Council', 'Songea Municipal Counci', 'Tabora Municipal Council']
                               Geochaina : ['Geochaina']
                          Namungo Miners : ['Namungo Miners']
                        Mileniam Project : ['Mileniam Project', 'Rilayo Water Project']
                       Tajiri Jumbe Lila : ['Tajiri Jumbe Lila']
                                     Ham : ['Haam', 'Ham']
                                  Mataro : ['Mataro', 'Matogoro', 'Mayiro']
                                  Tredep : ['Tredep', 'Tredsp', 'Treedap', 'Tridep']
                                Moravian : ['Moravian', 'Morovian', 'Morrovian']
                                Nethalan : ['Natherland', 'Nerthlands', 'Nethalan', 'Netherla', 'Netherland', 'Netherlands']
                                    Aict : ['Aict']
                      Mzee Waziri Tajari : ['Mzee Waziri Tajari']
                                      Ju : ['Ju']
                        Summit For Water : ['Summit For Water']
                         Water Aid /sema : ['Wate Aid/sema', 'Water /sema', 'Water Aid /sema', 'Water Aid/dwe', 'Water Aid/sema']
                             Halmashauri : ['Gra Na Halmashauri', 'Halimashau', 'Halimashauli', 'Halmashauli', 'Halmashaur', 'Halmashauri', 'Halmashauri Wil']
                                 Eu/acra : ['Eu/acra']
                Grail Mission Kiseki Bar : ['Grail Mission Kiseki Bar']
                                 Zinduka : ['Zinduka']
                                 Qwekwin : ['Quwkwin', 'Qwckwin', 'Qwekwin', 'Qwickwin']
                                Mwigicho : ['Mwigicho']
                                 Nginila : ['Nginila']
                                   Kilol : ['Kilol']
                                  Caltus : ['Caltas', 'Caltus', 'Craelius']
                                   Taipo : ['Taipo']
                   World Bank/government : ['Danida /government', 'Norad /government', 'Norad/government', 'World Bank/government']
                         Lake Tanganyika : ['Lake Tanganyika', 'Lake Tanganyika Basin', 'Lake Tanganyika Prodap']
                Mwl. Nyerere Sec. School : ['Mwl. Nyerere Sec. School']
                            Village Fund : ['Village Communi', 'Village Community', 'Village Council', 'Village Fund', 'Village Govt', 'Village Office', 'Village Res', 'Villege Council']
                                    Tove : ['Tove']
                         Matata Selemani : ['Matata Selemani', 'Rajab Seleman', 'Yasini Selemani']
                                  France : ['Franc', 'France']
                                   Minis : ['Minis']
                                 Tabraki : ['Tabraki']
                                  Rished : ['Rashid', 'Rished']
                                     Hsw : ['Hsw']
            Village Council/ Rose Kawala : ['Village Council/ Haydom Luther', 'Village Council/ Rose Kawala']
                              Jimbo Fund : ['Jimbo Fund']
                     Zingibali Secondary : ['Kagunguli Secondary', 'Loliondo Secondary', 'Zingibali Secondary']
                              Action Aid : ['Action Aid', 'Action In A']
                                  Laizer : ['Laizer']
                             Aco/germany : ['A/co Germany', 'Aco/germany']
                                     Obc : ['Obc']
                                 African : ['Africa', 'African', 'Africare']
                           Idara Ya Maji : ['Idara Ya Maji', 'Wirara Ya Maji']
                                  Amrefe : ['Amref', 'Amrefe']
                                Kkkt Dme : ['Kkkt Dme', 'Kkkt Mareu', 'Kkkt Usa']
                                  Shanta : ['Shanta']
                                    Cdtf : ['Cdtf']
                     Nyamingu Subvillage : ['Nyamingu Subvillage']
                          Staford Higima : ['Staford Higima']
                     Village Contributio : ['Village Contributio', 'Villlage Contributi']
                                  Abasia : ['Abas Ka', 'Abasia', 'Obadia']
                                    Miab : ['Miab']
                        Japan Government : ['Belgian Government', 'China Government', 'Cipro/government', 'Colonial Government', 'Danida /government', 'Egypt Government', 'Finland Government', 'Irish Government', 'Italy Government', 'Japan Government', 'Misri Government', 'Norad /government', 'Norad/government', 'Tcrs /government', 'Unhcr/government', 'Village Government']
                                Matogoro : ['Matogoro']
                   Shelisheli Commission : ['Shelisheli Commission']
                        Italy Government : ['Belgian Government', 'China Government', 'Cipro/government', 'Colonial Government', 'Danida /government', 'Egypt Government', 'Finland Government', 'Irish Government', 'Isf/government', 'Italy Government', 'Japan Government', 'Lwi & Central Government', 'Misri Government', 'Norad /government', 'Norad/government', 'Tcrs /government', 'Unhcr/government', 'Village Government']
                                    Tdrs : ['Tcrs', 'Tdrs', 'Tgrs']
                               Carmatech : ['Camartec', 'Carmatech']
                            Mgaya Masese : ['Mgaya Masese']
                                   Kalta : ['Caltas', 'Kalitasi', 'Kalta', 'Kata']
                                    Plan : ['Plan']
                               Greinaker : ['Greinaker', 'Greineker']
                            Isf / Tasaff : ['Isf / Tasaff']
                  Kikundi Cha Akina Mama : ['Kikundi Cha Akina Mama']
                              Kadres Ngo : ['Kadres Ngo', 'Karadea Ngo', 'Kdrdp Ngo']
                                      Br : ['Br']
                                   Abdul : ['Abdala', 'Abdul']
                                  Rashid : ['Rashid', 'Rished']
                                  Tassaf : ['Nassan', 'Taasaf', 'Tasaf', 'Tasafu', 'Tassaf', 'Tassaf I', 'Tassaf Ii']
                                     Mtc : ['Mrtc', 'Mtc']
                 Okutu Village Community : ['Buluga Subvillage Community', 'Kitiangare Village Community', 'Ngiresi Village Community', 'Okutu Village Community', 'Oldadai Village Community', 'Olgilai Village Community', 'Sekei Village Community', 'Tcrs/village Community', 'Village Community']
                                   Ballo : ['Ballo', 'Balo']
                                     Ola : ['Ola']
                                   Malec : ['Malec', 'Males']
                              Upper Ruvu : ['Upper Ruvu']
                                    Dina : ['Dina']
                 Songea District Council : ['Cdtfdistrict Council', 'District Council', 'Mbozi District Council', 'Mheza Distric Counc', 'Mkinga Distric Coun', 'Sangea District Council', 'Sengerema District Council', 'Songea District Council', 'Songea Municipal Counci', 'Wb / District Council']
                                 College : ['College']
                                 Mosqure : ['Mosque', 'Mosqure']
                          Gachuma Ginery : ['Gachuma Ginery']
                                  Church : ['Agt Church', 'Aic Church', 'Churc', 'Church', 'Pag Church', 'Rc Church', 'Sda Church', 'Tag Church']
                                 Concern : ['Cocern', 'Concen', 'Concern']
                                    Cefa : ['Cefa']
                                   Italy : ['Italy']
                           British Tanza : ['British Tanza']
                                   Usaid : ['Usaid']
                 Internal Drainage Basin : ['Internal Drainage Basin']
                                 Shawasa : ['Bahewasa', 'Dawasa', 'Sauwasa', 'Sawaka', 'Shawasa', 'Sowasa', 'Suwasa']
                                    Kadp : ['Dadp', 'Kadip', 'Kadp', 'Kidp']
                                     Irc : ['Irc']
                                    Nddp : ['Nddp', 'Ndrdp']
                               Killflora : ['Killflora']
                                    Cope : ['Cope']
                                Swiss If : ['Swiss If', 'Swiss Tr']
                                  Tacare : ['Tacare']
                                    Luka : ['Duka', 'Luka']
                                   U.S.A : ['U.S.A']
                             Cefa-njombe : ['Cefa-njombe']
                                Pancrasi : ['Pancrasi', 'Pankrasi']
                                Dhv\swis : ['Dhv\\swis']
                       Sisal Estste Hale : ['Sisal Estste Hale']
                          Mwanamisi Ally : ['Mwanamisi Ally']
                                     Ilo : ['Ilo']
                        Kkkt Ndrumangeni : ['Kkkt Ndrumangeni']
                     Mkinga Distric Coun : ['Kilindi District Co', 'Mbozi District Council', 'Mheza Distric Counc', 'Mkinga  Distric Cou', 'Mkinga Distric Coun', 'Sangea District Council', 'Sengerema District Council', 'Songea District Council']
                                  Norani : ['Mhoranzi', 'Moradi', 'Norani', 'Uhoranzi']
                                   Mkuyu : ['Makuru', 'Mkuyu']
                                Kalitasi : ['Kalitasi', 'Kalitesi', 'Kanisani']
                       Pentecosta Church : ['Free Pentecoste Church Of Tanz', 'Methodist Church', 'Pentecosta Church', 'Pentecosta Seela', 'Pentecostal Church']
                                    Jica : ['Jaica', 'Jeica', 'Jica', 'Jika', 'Jipa']
                                Care Int : ['Care Int']
                                Villages : ['Villaers', 'Village', 'Village Fund', 'Village Govt', 'Village Res', 'Villagers', 'Villagers Mpi', 'Villages', 'Villegers']
                                 Lottery : ['Lottery', 'Lottery Club']
                              Pag Church : ['Agt Church', 'Aic Church', 'Baptist Church', 'Batist Church', 'Fpct Church', 'Kkkt Church', 'Nazalet Church', 'Pag Church', 'Rc Church', 'Roman Church', 'Sda Church', 'Tag Church', 'Tag Church Ub']
                      Zao Water Spring X : ['Zao Water Spring', 'Zao Water Spring X']
                                   Madra : ['Madra']
                                  Shekhe : ['Shekhe']
                                Irish Ai : ['Irish Ai']
                                 Benguka : ['Benguka']
                     Handeni Trunk Maini : ['Handeni Trunk Main(', 'Handeni Trunk Maini']
               Africa Project Ev Germany : ['Africa Project Ev Germany']
                                  Tuwasa : ['Auwasa', 'Dawasa', 'Hewasa', 'Kuwasa', 'Liuwassa', 'Lowasa', 'Mbiuwasa', 'Mtuwasa', 'Muwasa', 'Sauwasa', 'Sowasa', 'Suwasa', 'Tuwasa']
                                  Ramsar : ['Ramsar']
                              Raramataki : ['Ilaramataki', 'Laramatak', 'Raramataki']
                                     W.B : ['W.B']
                                    Mrtc : ['Mrtc']
                                 Vicfish : ['Vicfish', 'Vicfish Ltd', 'Vickfis']
                    St Elizabeth Majengo : ['St Elizabeth Majengo']
                                    Pema : ['Pema', 'Sema']
                           Game Division : ['Game Division']
                                      Ox : ['Ox']
                                Mbiuwasa : ['Liuwassa', 'Mbiusa', 'Mbiuwasa', 'Mtuwasa', 'Muwasa']
                                     Aic : ['Aic', 'Aict']
                     Handeni Trunk Main( : ['Handeni Trunk Main(', 'Handeni Trunk Maini']
                                Kokornel : ['Kokornel']
                              Peace Cope : ['Peace Cope']
                                    Finw : ['Finw']
                         Yasini Selemani : ['Matata Selemani', 'Yasini Selemani']
                                    Bank : ['Bank']
                                 Wfp/tnt : ['Wfp/tnt']
                             Rotaty Club : ['Lotary Club', 'Lottery Club', 'Rotary Club', 'Rotaty Club']
                     Colonial Government : ['Belgian Government', 'British Colonial Government', 'China Government', 'Colonial Government', 'Danida /government', 'Finland Government', 'Irish Government', 'Italy Government', 'Japan Government', 'Lwi & Central Government', 'Misri Government', 'Village Government', 'World Bank/government']
                                   Luthe : ['Luthe', 'Lutheran', 'Ruthe']
                             Action In A : ['Action Aid', 'Action In A']
                       Kiwanda Cha Ngozi : ['Kiwanda Cha Ngozi', 'Kiwanda Cha Samaki', 'Kiwanda Cha Tangawizi']
                                   Franc : ['Franc', 'France']
                           Comunedi Roma : ['Comune Di Roma', 'Comunedi Roma']
                         Water Authority : ['Mwanga Town Water Authority', 'Water Authority']
                 Lee Kang Pyung's Family : ["Lee Kang Pyung's Family"]
                      Silvester Shilingi : ['Silvester Shilingi']
                                Drdp Ngo : ['Drdp Ngo', 'Kdrdp Ngo']
                                  Nrwssp : ['Drwssp', 'Nrwssp', 'Nwssp']
                             John Skwese : ['John Skwese']
                                 W.F.D.P : ['W.F.D.P']
                                Villaers : ['Villaers', 'Village Res', 'Villagers', 'Villagers Mpi', 'Villages', 'Villegers']
                    Women Fo Partnership : ['Women Fo Partnership', 'Women For Partnership']
                                       O : []
                             Vicfish Ltd : ['Vicfish Ltd']
                                  Tridep : ['Tredep', 'Tredsp', 'Tridep']
                   Mtuwasa And Community : ['Government And Community', 'Mtuwasa And Community']
                      Gra Na Halmashauri : ['Gra Na Halmashauri']
                 Kindoroko Water Project : ['Kindoroko Water Project', 'Rilayo Water Project']
                                   Biore : ['Biore']
                         Dominiki Simwen : ['Dominiki Simwen']
                                   Jimmy : ['Jimmy']
                    African 2000 Network : ['Africa 2000 Network/undp', 'African 2000 Network']
                                  Kapelo : ['Kapelo']
                           Rc Missionary : ['German Missionary', 'Germany Missionary', 'Missionary', 'Rc Mission', 'Rc Missionary']
                                   Hesaw : ['Gesawa', 'Hasawa', 'Hesaw', 'Hesawa', 'Hesawwa', 'Hesawz', 'Hesawza', 'Hesswa', 'Hewawa', 'Hhesawa']
                                    Tltc : ['Tltc']
                       Devon Aid Korogwe : ['Devon Aid Korogwe']
            Mwalimu  Maneromango Muhenzi : ['Mwalimu  Maneromango Muhenzi']
                                Care/dwe : ['Care/dwe']
                                    Sido : ['Sida', 'Sido', 'Sipdo']
                      Louise Elucas Sala : ['Louise Elucas Sala']
                          Friend From Un : ['Friend From Un']
                                     Msf : ['Msf']
                                    Jipa : ['Jica', 'Jika', 'Jipa']
                     Kkkt-dioces Ya Pare : ['Kkkt-dioces Ya Pare']
                               Villagers : ['Villaers', 'Village', 'Village Fund', 'Village Govt', 'Village Res', 'Villagers', 'Villagers Mpi', 'Villages', 'Villegers']
                         Education Funds : ['Education Funds']
                              Un Habitat : ['Un Habitat']
                     Stp-sustainable Tan : ['Stp-sustainable Tan']
                                 Bukumbi : ['Bukumbi']
                             Safari Roya : ['Safari Camp', 'Safari Roya']
            Shirika La Kinamama Na Watot : ['Shirika La Kinamama Na Watot']
                                     Wvt : ['Wvt']
                                Mafwimbo : ['Mafwimbo']
                                Foreigne : ['Foreigne']
                                     Wvc : ['Wvc']
                           African Relie : ['African Relie', 'Afriican Reli']
                           Mwelia Estate : ['Mwelia Estate', 'Segera Estate']
                      Private Individual : ['Private Individual', 'Private Individul', 'Private Institutions']
                              Natherland : ['Natherland', 'Netherla', 'Netherland', 'Netherlands']
                   Tlc/thimotheo Masunga : ['Tlc/thimotheo Masunga']
                       Bread For The Wor : ['Bread For The Wor', 'Bread Of The Worl']
                          Sister Francis : ['Sister Francis', 'Siter Fransis']
                       Norad /government : ['Belgian Government', 'China Government', 'Cipro/government', 'Colonial Government', 'Danida /government', 'Egypt Government', 'Finland Government', 'Irish Government', 'Isf/government', 'Italy Government', 'Japan Government', 'Misri Government', 'Norad /government', 'Norad/government', 'Tcrs /government', 'Unhcr/government', 'Village Government', 'World Bank/government']
                    African Barrick Gold : ['African Barrick Gold']
                         Calvary Connect : ['Calvary Connect']
                                    Hiap : ['Hiap']
                                    Dfid : ['Dfid']
                         People Of Japan : ['People From Japan', 'People Of Japan', 'People Of Sweden', 'The People Of Japan']
               Wamisionari Wa Kikatoriki : ['Wamisionari Wa Kikatoriki', 'Wamissionari Wa Kikatoriki']
                                   Lgcgd : ['Lcgd', 'Ldcgd', 'Lgcd', 'Lgcgd']
                                  Nyeisa : ['Nyeisa']
                                  Africa : ['Afric', 'Africa', 'African', 'Africare']
                           Institutional : ['Insititutiona', 'Institution', 'Institutional', 'Insututional']
                                Craelius : ['Craelius']
                                Mh.Chiza : ['Mh.Chiza']
                                 G.D&i.D : ['G.D&i.D']
                            Nassor Fehed : ['Nassor Fehed']
                               Tlc/sorri : ['Tlc/samora', 'Tlc/sorri']
                                Sent Tho : ['Sent Tho']
          Regional Water Engineer Arusha : ['Regional Water Engineer Arusha']
                                    Acra : ['Acra', 'Adra']
                     Goldwill Foundation : ['Goldwill Foundation', 'Kombe Foundation', 'Moslem Foundation']
                 Sangea District Council : ['Cdtfdistrict Council', 'District Council', 'Mbozi District Council', 'Mheza Distric Counc', 'Mkinga Distric Coun', 'Sangea District Council', 'Sengerema District Council', 'Songea District Council', 'Songea Municipal Counci', 'Wb / District Council']
                                     Ics : ['Ics']
                           Twende Pamoja : ['Twende Pamoja']
                                      Ta : ['Ta']
                            Siza Mayengo : ['Siza Mayengo', 'St Elizabeth Majengo']
                    Bukwang Church Saint : ['Bukwang Church Saint', 'Bukwang Church Saints']
                         Richard M.Kyore : ['Richard M.Kyore']
                              Rc/mission : ['Rc Mission', 'Rc Missionary', 'Rc/mission']
                                     Mac : ['Mac']
                              Nmdc India : ['Nmdc India']
                                 Bakwata : ['Bahewasa', 'Bakwata']
                          Roman Catholic : ['Romam Catholic', 'Roman Catholic', 'Roman Cathoric', 'Roman Cathoric -kilomeni', 'Roman Cathoric Church', 'Roman Cathoric Same', 'Roman Cathoric-same']
                        Diocese Of Geita : ['Diocese Of Geita']
                            Matimbwa Sec : ['Matimbwa Sec']
                                  Fosecu : ['Fosecu']
           Manyovu Agriculture Institute : ['Manyovu Agriculture Institute']
                                 Uvimaki : ['Uvimaki']
                                  Makona : ['Makanga', 'Makona', 'Makonde', 'Makonder', 'Makori', 'Makundya', 'Makusa', 'Malola']
                               Orphanage : ['Orphanage']
                                Tz Japan : ['Tz Japan']
                       Watu Wa Ujerumani : ['Watu Wa Marekani', 'Watu Wa Ujerumani']
                                    Cast : ['Cast']
                                 Railway : ['Railway']
                                 Dawasco : ['Dawasa', 'Dawasco']
                Government /world Vision : ['Government /world Vision', 'Government/ World Bank']
                             Wua And Ded : ['Doner And Ded', 'Wua And Ded', 'Wug And Ded']
                                      Af : ['Af']
                                      Ai : ['Ai']
                 Sekei Village Community : ['Buluga Subvillage Community', 'Kitiangare Village Community', 'Ngiresi Village Community', 'Okutu Village Community', 'Oldadai Village Community', 'Olgilai Village Community', 'Sekei Village Community', 'Tcrs/village Community', 'Village Community']
                              Lions Club : ['Lion Clu', 'Lions Club']
                                   Scott : ['Scott']
                                 Village : ['Subvillage', 'Villaers', 'Village', 'Village Fund', 'Village Govt', 'Village Res', 'Villagers', 'Villages', 'Villegers']
          Roman Catholic Rulenge Diocese : ['Roman Catholic Rulenge Diocese']
                           Msikiti Masji : ['Msikiti Masji']
                            World Vision : ['World Vision', 'World Vision/ Kkkt', 'World Vision/adra', 'World Vision/rc Church', 'Worldvision']
                                     Giz : ['Giz']
                                    Afdp : ['Afdp', 'Asdp']
                          Makoye Masanzu : ['Makoye Masanzu']
                                    Wsdp : ['Asdp', 'Dsdp', 'Wsdo', 'Wsdp', 'Wssp']
                            Busoga Trust : ['Busoga Trust']
                               Japan Aid : ['Canada Aid', 'Japan Aid', 'Japan Food', 'Japan Food Aid']
                                  Cocern : ['Cocen', 'Cocern', 'Concen', 'Concern']
                                    Wsdo : ['Wsdo', 'Wsdp']
                      Finland Government : ['Belgian Government', 'China Government', 'Colonial Government', 'Danida /government', 'Egypt Government', 'Finland Government', 'Irish Government', 'Italy Government', 'Japan Government', 'Lwi & Central Government', 'Misri Government', 'Norad /government', 'Norad/government', 'Village Government', 'World Bank/government']
                                   Schoo : ['Schoo', 'School']
                                 Holland : ['Holand', 'Holland', 'Totoland']
                        Noeli Mahobokela : ['Noeli Mahobokela']
                         Government/tcrs : ['Government /sda', 'Government /tassaf', 'Government /world Vision', 'Government Of Misri', 'Government/ World Bank', 'Government/school', 'Government/tassaf', 'Government/tcrs']
                                       P : []
                                  Lungwe : ['Lungwe']
                                 Weepers : ['Weepers']
                          Jeshi Lawokovu : ['Jeshi La Wokovu', 'Jeshi La Wokovu [cida]', 'Jeshi Lawokovu']
                           Jumanne Siabo : ['Jumanne Siabo']
                Engineers Without Border : ['Engineers Without Border']
                              Tasaf/dmdd : ['Tasaf/dmdd']
                               Mwakifuna : ['Mwakalinga', 'Mwakifuna']
                                  Magige : ['Magige']
                                Serikari : ['Serikali', 'Serikari', 'Serikaru']
                             Haruna Mpog : ['Haruna Mpog']
                                     Tgz : ['Tgz']
                                 Kizenga : ['Kizenga']
                       Marumbo Community : ['Arab Community', 'Arabs Community', 'Government/ Community', 'Igolola Community', 'Ilwilo Community', 'Islamic Community', 'Marumbo Community', 'Maseka Community', 'Mtuwasa And Community', 'Village Community']
                                   Magul : ['Magul']
                                   Mh An : ['Mh An']
                       Steven Nyangarika : ['Steven Nyangarika']
                                  Bruder : ['Bruder']
                            A/co Germany : ['A/co Germany', 'Aco/germany']
                                   Daldo : ['Daldo']
                                 Enyuati : ['Enyuati', 'Enyueti']
                       Siss M. Minghetti : ['Siss M. Minghetti']
                               Kdrdp Ngo : ['Drdp Ngo', 'Kadres Ngo', 'Karadea Ngo', 'Kdrdp Ngo']
                         Loliondo Parish : ['Kalebejo Parish', 'Kilimarondo Parish', 'Loliondo Parish']
                                   Daida : ['Dagida', 'Daida', 'Danida', 'Dqnida']
                             Unice/ Cspd : ['Unice/ Cspd', 'Unicef/ Csp', 'Unicef/cspd']
                                   Muwsa : ['Auwasa', 'Kuwasa', 'Mbiuwasa', 'Mtuwasa', 'Muwasa', 'Muwsa', 'Suwasa', 'Tuwasa']
           Halmashauri Ya Manispa Tabora : ['Halmashauri Ya Manispa Tabora', 'Halmashauri Ya Wilaya Sikonge']
                            Tumaini Fund : ['Tumaini Fund']
                              Private Co : ['Private Co', 'Private Owned', 'Private Person']
              Living Water International : ['Living Water International', 'Muslimehefen International']
                                   Greec : ['Greec']
                          Musilim Agency : ['African Muslim Agency', 'Musilim Agency']
                                     Wdp : ['Wdp', 'Wdsp', 'Wsdp']
                             Nyanza Road : ['Nyanza Road']
                                 Isf/gvt : ['Isf/gvt']
                                   Kaaya : ['Kaaya', 'Kamama']
                                    Lips : ['Lips', 'Rips']
                              Mango Tree : ['Mango Tree']
                               St Gasper : ['St Gasper']
                        Tanedaps Society : ['Tanedaps Society']
                        Christan Outrich : ['Christan Outrich', 'Christian Outrich', 'Cristan Outrich']
                                   Hindu : ['Hindu']
                                Tcrs.Tlc : ['Tcrs.Tlc']
                                   Shipo : ['Shipo']
                                   Msudi : ['Msudi']
                             Said Hashim : ['Said Hashim']
                       Private Individul : ['Private Individual', 'Private Individul', 'Private Institutions']
               Olgilai Village Community : ['Buluga Subvillage Community', 'Kitiangare Village Community', 'Ngiresi Village Community', 'Okutu Village Community', 'Oldadai Village Community', 'Olgilai Village Community', 'Sekei Village Community', 'Tcrs/village Community']
                                      Fw : ['Fw']
                           Insititutiona : ['Insititutiona', 'Institution', 'Institutional', 'Insututional']
                              Su-ki Jang : ['Su-ki Jang']
                                   Lgcdg : ['Lcdg', 'Lgcbg', 'Lgcd', 'Lgcdg']
                              Msf/tacare : ['Isf/tacare', 'Msf/tacare']
                             Rotary Club : ['Lotary Club', 'Lottery Club', 'Rotary Club', 'Rotaty Club']
                               Adp Bungu : ['Adp Bungu']
                           Mmg Gold Mine : ['Mmg Gold Mine', 'Nyamongo Gold Mining', 'Tulawaka Gold Mine']
            Swisland/ Mount Meru Flowers : ['Swisland/ Mount Meru Flowers', 'Swisland/mount Meru Flowers']
                         Government /sda : ['Government /sda', 'Government /tassaf', 'Government /world Vision', 'Government Of Misri', 'Government Of Tanzania', 'Government/ World Bank', 'Government/school', 'Government/tassaf', 'Government/tcrs']
                           Mh.J S Sumari : ['Mh.J S Sumari']
                                  Auwasa : ['Auwasa', 'Dawasa', 'Hewasa', 'Kuwasa', 'Liuwassa', 'Lowasa', 'Mbiuwasa', 'Mtuwasa', 'Muwasa', 'Sauwasa', 'Sowasa', 'Suwasa', 'Tuwasa']
                                     Snv : ['Snv']
                           Mwalimu Omari : ['Mbwana Omari', 'Mwalimu Omari']
                                     Vwt : ['Vwt']
                         Tlc/john Majala : ['Tlc/john Majala']
                                Cvs Miss : ['Cpps Mission', 'Cvs Miss']
                                    Hapa : ['Hapa']
                         Cristan Outrich : ['Christan Outrich', 'Christian Outrich', 'Cristan Outrich']
                                     Vwc : ['Vwc']
                            Peter Mayiro : ['Peter Mayiro']
                                    Adra : ['Acra', 'Adra']
                            Jafary Mbaga : ['Jafary Mbaga']
                           Kanisa La Tag : ['Kanisa La Menonite', 'Kanisa La Mitume', 'Kanisa La Neema', 'Kanisa La Tag']
                                    Taes : ['Taees', 'Taes']
                                Ilo/undp : ['Ilo/undp']
                                 Nyahale : ['Nyahale']
                                   Ndrdp : ['Mdrdp', 'Nddp', 'Ndrdp']
                   Bukwang Church Saints : ['Bukwang Church Saint', 'Bukwang Church Saints']
                           Oldonyolengai : ['Oldonyolengai']
                                   Roman : ['Roman', 'Roman Ca']
                                 Hesawwa : ['Gesawa', 'Hasawa', 'Hesawa', 'Hesawwa', 'Hesawz', 'Hesawza', 'Hesswa', 'Hewawa', 'Hhesawa']
                                   Japan : ['Japan', 'Tz Japan']
                                  Sabemo : ['Sabemo', 'Sabodo']
                                Serikali : ['Serikali', 'Serikari', 'Serikaru']
                                   Dwssp : ['Dassip', 'Drwssp', 'Dwsdp', 'Dwsp', 'Dwssp', 'Nrwssp', 'Nwssp', 'Rwssp', 'Rwsssp']
                                   Kinga : ['Kinapa', 'Kinga', 'Kizenga']
                               Community : ['Arab Community', 'Arabs Community', 'Community', 'Community Bank', 'Ilwilo Community', 'Maseka Community', 'Tlc/community']
              Sengerema District Council : ['Mbozi District Council', 'Sangea District Council', 'Sengerema District Council', 'Songea District Council', 'Wb / District Council']
                                  Wilson : ['Wilson']
                                  Sumriy : ['Sumriy']
                  Da Unoperaio Siciliano : ['Da Unoperaio Siciliano']
                                     Aar : ['Aar']
                          Kamata Project : ['Kamata Project', 'Mileniam Project', 'Rilayo Water Project']
                                 Getekwe : ['Getekwe']
                                  Muwasa : ['Auwasa', 'Dawasa', 'Hewasa', 'Kuwasa', 'Liuwassa', 'Lowasa', 'Mbiuwasa', 'Mtuwasa', 'Muwasa', 'Muwsa', 'Sauwasa', 'Sowasa', 'Suwasa', 'Tuwasa']
                              Rocci Ross : ['Rocci Ross']
                      Village Government : ['Belgian Government', 'China Government', 'Colonial Government', 'Egypt Government', 'Finland Government', 'Irish Government', 'Italy Government', 'Japan Government', 'Lwi & Central Government', 'Misri Government', 'Village Government']
                               Dwe/norad : ['Dwe/norad', 'Rudep/norad']
                              Wamarekani : ['Wajerumani', 'Wamarekani', 'Watu Wa Marekani']
                                   Livin : ['Livin']
                                  Serena : ['Serena', 'Seronera']
                                     Twe : ['Twe']
                                 Muhindi : ['Muhindi']
                                  Birage : ['Birage']
                                Cobashec : ['Cobashec']
                                    Adap : ['Adap']
                                    Tasa : ['Taasaf', 'Tasa', 'Tasad', 'Tasae', 'Tasaf', 'Tasafu', 'Tasf', 'Tassaf', 'Tuwasa']
                          Total Landcare : ['Total Land Care', 'Total Landcare', 'Totaland Care', 'Totoland Care']
                                    Tasf : ['Taasaf', 'Tasa', 'Tasaf', 'Tasafu', 'Tasef', 'Tasf', 'Tassaf']
                                Boazi /o : ['Boazi /o']
                       People From Egypt : ['People From Egypt', 'People From Japan']
                              Wajerumani : ['Wajerumani', 'Wamarekani', 'Watu Wa Ujerumani']
                     Irevea Sister Water : ['Irevea Sister Water']
                           Sadaqatun Jar : ['Sadaqatun Jar']
                                     Prf : ['Prf']
                                    Bfwd : ['Bfwd']
                        Tanzania Journey : ['Tanzania Compasion', 'Tanzania Journey']
           Domestic Rural Development Pr : ['Domestic Rural Development Pr', 'Domestic Rural Development Pro']
                                    Kata : ['Kalta', 'Kata']
                                Getdsc00 : ['Getdsc00']
                           Legeza Legeza : ['Legeza Legeza']
                                 Makanga : ['Makanga', 'Makona', 'Makundya', 'Mganga', 'Mwakalinga']
                         Kanisa La Neema : ['Kanisa La Menonite', 'Kanisa La Mitume', 'Kanisa La Neema', 'Kanisa La Tag']
                                   Cheni : ['Chani', 'Cheni']
                                   Kuamu : ['Kuamu']
                                Miziriol : ['Miziriol']
                            Seleman Seif : ['Seleman Masoud', 'Seleman Rashid', 'Seleman Seif']
                      Loliondo Secondary : ['Loliondo Secondary', 'Zingibali Secondary']
                                    Icap : ['Icap', 'Icdp']
                               Kiliwater : ['Fini Water', 'Finwater', 'Kiliwater', 'Kilwater']
                                  Sowasa : ['Auwasa', 'Dawasa', 'Hewasa', 'Kuwasa', 'Lowasa', 'Muwasa', 'Sauwasa', 'Sawaka', 'Shawasa', 'Sowasa', 'Suwasa', 'Tuwasa']
                       People From Japan : ['People From Egypt', 'People From Japan', 'People Of Japan', 'The People Of Japan']
                   Women For Partnership : ['Women Fo Partnership', 'Women For Partnership']
                                   Mboma : ['Mboma', 'Taboma']
                         Jeshi La Wokovu : ['Jeshi La Wokovu', 'Jeshi La Wokovu [cida]', 'Jeshi Lawokovu']
                                    Sema : ['Pema', 'Sema', 'Sema S', 'Semaki']
                                 Msikiti : ['Msikiti', 'Msikitini', 'Mstiiti']
                                   Rodri : ['Rodri', 'Rudri']
                                   Ermua : ['Ermua']
                                    Juma : ['Juma', 'Jumaa']
                                     Tkc : ['Tkc']
                                Camartec : ['Camartec', 'Carmatech']
                             Water /sema : ['Wate Aid/sema', 'Water /sema', 'Water Aid /sema', 'Water Aid/sema', 'Water User As']
                                    Lamp : ['Lamp']
                                   Koico : ['Koica', 'Koico']
                             Mwita Lucas : ['Mwita Lucas', 'Mwita Muremi']
                                   Koica : ['Koica', 'Koico']
                                   Local : ['Local']
                     National Rural (wb) : ['National Rural', 'National Rural (wb)', 'National Rural And Hfa']
                                  Loocip : ['Loocip']
                                 Jumanne : ['Jumanne']
                            Leopad Abeid : ['Leopad Abeid']
                                  Semaki : ['Rumaki', 'Sema S', 'Semaki', 'Semaki K', 'Simavi']
                              Finn Water : ['Fin Water', 'Fini Water', 'Finn Water', 'Finwater', 'Wanginyi Water']
                               Rc Church : ['Agt Church', 'Aic Church', 'Fpct Church', 'Kkkt Church', 'Pag Church', 'Rc Churc', 'Rc Church', 'Rc Church/centr', 'Roman Church', 'Sda Church', 'Tag Church']
                       German Missionary : ['German Missionary', 'Germany Misionary', 'Germany Missionary']
                                      Kc : ['Kc']
                                     Hdv : ['Hdv']
                                      Ka : ['Ka']
                                     Gdp : ['Gdp']
                                      Ki : ['Ki']
                                   Ba As : ['Ba As']
                                   Suasa : ['Auwasa', 'Kuwasa', 'Muwasa', 'Sauwasa', 'Sowasa', 'Suasa', 'Suwasa', 'Tuwasa']
                                   Dhinu : ['Dhinu']
                                      Ku : ['Ku']
                               Tasaf/tlc : ['Tasaf/dmdd', 'Tasaf/tlc']
                       Old Nyika Company : ['Old Nyika Company']
                           Plan Tanzania : ['Caltas Tanzania', 'Cartas Tanzania', 'Plan Tanzania']
                 Magadini-makiwaru Water : ['Magadini Makiwaru Water', 'Magadini-makiwaru Water']
                                 Hhesawa : ['Gesawa', 'Hasawa', 'Hesawa', 'Hesawwa', 'Hesawz', 'Hesawza', 'Hesswa', 'Hewawa', 'Hhesawa']
                                Kerebuka : ['Kerebuka']
                                    Dwsp : ['Dasp', 'Dbsp', 'Drwssp', 'Dwsdp', 'Dwsp', 'Dwssp', 'Dwst', 'Rwsp']
                                   Churc : ['Churc', 'Church', 'Rc Churc']
                             Farm-africa : ['Farm Africa', 'Farm-africa']
                                   Peter : ['Peter', 'Peters']
                         Simango Kihengu : ['Simango Kihengu']
                                   Yaole : ['Yaole']
                               Dwe/rudep : ['Dwe/rudep']
                           Ndorobo Tours : ['Ndorobo Tours']
                  Mbozi Secondary School : ['Mbozi Secondary School']
                          National Rural : ['National Park', 'National Rural', 'National Rural (wb)', 'National Rural And Hfa']
                                   Baric : ['Baric']
                                 Maerere : ['Maerere', 'Magereza']
                                   Redap : ['Redap', 'Redep']
               Bong-kug Ohh/choonlza Lee : ['Bong-kug Ohh/choonlza Lee']
                                 Makonde : ['Makona', 'Makonde', 'Makonder', 'Makundya']
                                 Balyehe : ['Balyehe', 'Salehe']
                                Rc Missi : ['Rc Missi', 'Rc Mission', 'Rc Missionary', 'Rc Msufi', 'Rc/mission']
                                  Muniko : ['Muniko']
                Eung Am Methodist Church : ['Eung Am Methodist Church', 'Eung-am Methodist Church']
                             Ruangwa Lga : ['Ruangwa Lga']
                      Danida /government : ['Belgian Government', 'China Government', 'Cipro/government', 'Colonial Government', 'Danida /government', 'Finland Government', 'Irish Government', 'Japan Government', 'Norad /government', 'Norad/government', 'Tcrs /government', 'Unhcr/government', 'World Bank/government']
                        Unhcr/government : ['China Government', 'Cipro/government', 'Danida /government', 'Egypt Government', 'Finland Government', 'Irish Government', 'Isf/government', 'Italy Government', 'Japan Government', 'Misri Government', 'Norad /government', 'Norad/government', 'Tcrs /government', 'Unhcr/government']
                           Majengo Prima : ['Majengo Prima']
                        Water Department : ['Rural Water Department', 'Water Department']
                           Machibya Guma : ['Machibya Guma']
                                   Rural : ['Rural']
                             Isingiro Ho : ['Isingiro Ho']
                          Mamvua Kakungu : ['Mamvua Kakungu']
                                    Elct : ['Elca', 'Elct', 'Ilct']
                                    Elca : ['Elca', 'Elct']
                                   Lench : ['Lench']
                             Robert Mosi : ['Robert Loyal', 'Robert Mosi']
                                      Rv : ['Rv']
                                Dasp Ltd : ['Dasp Ltd']
             Mwanga Town Water Authority : ['Mwanga Town Water Authority']
                   Upendo Primary School : ['Luchelegu Primary School', 'Manyota Primary School', 'S.P.C Pre-primary School', 'Upendo Primary School']
                                     Mow : ['Mow']
                                     Htm : ['Htm']
                                    Undp : ['Undp']
                                 Jacobin : ['Jacobin']
                                   Rc Ch : ['Rc Ch', 'Rc Churc']
                  Government/ World Bank : ['Government /world Vision', 'Government Of Tanzania', 'Government/ Community', 'Government/ World Bank']
                       Ubalozi Wa Japani : ['Dwe/ubalozi Wa Marekani', 'Ubalozi Wa Japani', 'Ubalozi Wa Marekani']
                                  One Un : ['One Un']
                                   Tasaf : ['Taasaf', 'Tasa', 'Tasad', 'Tasae', 'Tasaf', 'Tasaf 1', 'Tasaf Ii', 'Tasafu', 'Tasef', 'Tasf', 'Tassaf', 'Tassaf I']
                                   Tasad : ['Taasaf', 'Tasa', 'Tasad', 'Tasae', 'Tasaf', 'Tasafu', 'Tassaf']
                                   Tasae : ['Taasaf', 'Tacare', 'Tasa', 'Tasad', 'Tasae', 'Tasaf', 'Tasafu', 'Tassaf']
                                Tanzania : ['Plan Tanzania', 'Tanzaling', 'Tanzania']
                         Bakari Chimkube : ['Bakari Chimkube']
                                  Mzungu : ['Mbunge', 'Mzung', 'Mzungu']
                                    Jwtz : ['Jwtz']
                                  Unicet : ['Unice', 'Unicef', 'Uniceg', 'Unicet', 'Unicrf', 'Uniseg']
                        Health  Ministry : ['Health  Ministry']
                                     Wbk : ['Wbk']
                                 Italian : ['Italian', 'Waitaliano']
           Resolute Golden Pride Project : ['Resolute Golden Pride Project']
                          William Acleus : ['William Acleus']
                             Wwf / Fores : ['Wwf / Fores']
                                    Tado : ['Iado', 'Nado', 'Tadeo', 'Tado', 'Tardo']
                                   Msabi : ['Msabi']
                                Bahewasa : ['Bahewasa']
                                 Norplan : ['Norplan']
                                      Pr : ['Pr']
                                   Lizad : ['Lizad']
                                    Area : ['Area']
                                     Jgb : ['Jgb']
                          Geita Goldmain : ['Geita Goldmain']
                  Lake Tanganyika Prodap : ['Lake Tanganyika Basin', 'Lake Tanganyika Prodap']
                                     Kmt : ['Kmt']
                                  Mbunge : ['Mbunge', 'Mzungu']
                                      Po : ['Po']
           Apm[africa Precious Metals Lt : ['Apm[africa Precious Metals Lt']
                                 Qwckwin : ['Quickwins', 'Quwkwin', 'Qwckwin', 'Qwekwin', 'Qwick Win', 'Qwickwin']
                                   Mamaz : ['Mamad', 'Mamaz']
                            Muslim World : ['Muslim Society', 'Muslim World']
                              Ces (gmbh) : ['Ces (gmbh)', 'Ces(gmbh)']
                           Mwita Machota : ['Mwita Kichere', 'Mwita Machota', 'Mwita Mahiti']
                                   Mamad : ['Mamad', 'Mamaz']
                        Rashid Seng'ombe : ["Rashid Seng'ombe"]
                             Henure Dema : ['Henure Dema']
                     Church Of Disciples : ['Church Of Disciples']
                          Teonas Wambura : ['Motiba Wambura', 'Rhobi Wambura', 'Teonas Wambura']
                Bingo Foundation Germany : ['Bingo Foundation Germany']
                        Gil Cafe'church' : ["Gil Cafe'church'"]
                           Wate Aid/sema : ['Wate Aid/sema', 'Water /sema', 'Water Aid /sema', 'Water Aid/dwe', 'Water Aid/sema']
                             Boma Saving : ['Boma Saving']
                                       S : []
                                   Zaben : ['Zaben']
                                   Bkhws : ['Bhws', 'Bkhws']
                                   Rc Mi : ['Rc Mi', 'Rc Missi', 'Rc Msufi']
                                Mp Mzeru : ['Mp Mzeru']
                                     Zao : ['Zao']
                                  Hamref : ['Hamref']
                              Tanzakesho : ['Tanzakesho']
             Tanz Egypt Technical Cooper : ['Egypt Technical Co Operation', 'Tanz Egypt Technical Cooper', 'Tanz/egypt Technical  Co-op', 'Tanzania Egypt Technical Co Op']
                              Iran Gover : ['Iran Gover']
                                  Prodap : ['Prodap']
          African Development Foundation : ['African Development Bank', 'African Development Foundation', 'African Reflections Foundation']
                                   Umoja : ['Umoja']
                                  Pataji : ['Pataji']
                                     Hez : ['Hez']
                             Global Fund : ['Global Fund']
                                  Suwasa : ['Auwasa', 'Dawasa', 'Hewasa', 'Kuwasa', 'Liuwassa', 'Lowasa', 'Mbiuwasa', 'Mtuwasa', 'Muwasa', 'Sauwasa', 'Sawaka', 'Shawasa', 'Sowasa', 'Suasa', 'Suwasa', 'Tuwasa']
                                W.D & I. : ['W.D & I.', 'W.D.&.I.']
                                Serikaru : ['Serikali', 'Serikari', 'Serikaru']
                               Nyamasagi : ['Nyamasagi']
                                    Sisa : ['Lisa', 'Sida', 'Sisa']
                                   Kaemp : ['Kaemp', 'Kahema']
                            Hassan Gulam : ['Hassan Gulam']
                              Rwssp/wsdp : ['Rwssp/wsdp']
                                     Gen : ['Gen']
                       Kibara Foundation : ['Bingo Foundation', 'Friends Of Kibara Foundation', 'Goldwill Foundation', 'Kibara Foundation', 'Kombe Foundation', 'Kuji Foundation', 'Moslem Foundation']
                                   Kidep : ['Kidep', 'Kidp', 'Kirdep', 'Lidep', 'Ridep', 'Tridep']
                             Water Board : ['Water Board']
                               Maliasili : ['Halimashauli', 'Maliasili']
                             Peter Tesha : ['Peter Ngereka', 'Peter Tesha']
                                Stantons : ['Stantons']
                                   Jamal : ['Jamal']
                            Norad/ Kidep : ['Norad/ Kidep', 'Norad/rudep']
                                   Vifaf : ['Vifaf', 'Vifafi', 'Vififi']
                                   Ebaha : ['Ebaha']
                              Tag Church : ['Agt Church', 'Aic Church', 'Baptist Church', 'Batist Church', 'Fpct Church', 'Kkkt Church', 'Nazalet Church', 'Pag Church', 'Rc Church', 'Roman Church', 'Sda Church', 'Tag Church', 'Tag Church Ub']
                               Singsinga : ['Singasinga', 'Singsinga']
                                  Dasiip : ['Dasiip', 'Dasip', 'Dassip']
                         Germany Republi : ['Germany Republi']
                                   Rhobi : ['Rhobi']
                                    Brdp : ['Brdp', 'Drdp']
                                 Mstiiti : ['Msikiti', 'Mstiiti']
               Ngiresi Village Community : ['Buluga Subvillage Community', 'Kitiangare Village Community', 'Ngiresi Village Community', 'Okutu Village Community', 'Oldadai Village Community', 'Olgilai Village Community', 'Sekei Village Community', 'Tcrs/village Community']
          Friends Of Ulambo And Mwanhala : ['Friends Of Ulambo And Mwanhala']
                                 Mwamama : ['Kamama', 'Kanamama', 'Mwamama']
              Comunity Construction Fund : ['Comunity Construction Fund', 'Friedkin Conservation Fund']
                                   Lgcbg : ['Lgcbg', 'Lgcdg', 'Lgdbg']
                                    Lvia : ['Lvia']
                                  Masese : ['Masese']
                        Thomasi Busigaye : ['Thomasi Busigaye']
                                 Swidish : ['Swedish', 'Swidish']
                                    Kibo : ['Kibo']
                                  Oxfarm : ['Oxfam', 'Oxfarm', 'Oxfarm Gb']
                            Robert Loyal : ['Robert Kampala', 'Robert Loyal', 'Robert Mosi']
                        Soko La Magomeni : ['Soko La Magomeni']
                                    Idea : ['Idea']
                                Nazaleti : ['Nazaleti']
                                 Kyariga : ['Kyariga', 'Maro Kyariga']
                      Africa Amini Alama : ['Africa Amini Alama']
                       Mwanaisha Mwidadi : ['Mwanaisha Mwidadi']
                                    Tdft : ['Cdft', 'Tdft']
                                   Morad : ['Morad', 'Moradi', 'Norad']
                                 Inkinda : ['Inkinda']
                                Solidarm : ['Solidame', 'Solidarm', 'Soliderm']
                       Cc Motor Day 2010 : ['Cc Motor Day 2010']
                                   Tcrst : ['Tcrs', 'Tcrst']
                                   Hashi : ['Hashi', 'Rashid']
                                 Warento : ['Tareto', 'Warento']
                           Water User As : ['Water User As', 'Water User Group']
                                Presadom : ['Presadom']
                                   Taees : ['Taees', 'Taes']
                                  Obadia : ['Abasia', 'Obadia']
                                   Kando : ['Kando']
                                Lutheran : ['Lutheran', 'Natherland', 'Netherland']
                                 Company : ['Company']
                          Mfuko Wa Jimbo : ['Mfuko Wa Jimbo', 'Mfuko Wa Jimbo La Magu']
                                Kanamama : ['Kamama', 'Kanamama']
                                     Fao : ['Fao']
                     Ministry Of Healthy : ['Ministry Of Agricultura', 'Ministry Of Education', 'Ministry Of Healthy', 'Ministry Of Water']
                                      Bs : ['Bs']
                               Wfp/usaid : ['Wfp/tnt/usaid', 'Wfp/usaid', 'Wfp/usaid/tnt']
                             Institution : ['Insititutiona', 'Institution', 'Institutional', 'Insututional', 'Private Institutions']
                           Wfp/tnt/usaid : ['Wfp/tnt/usaid']
                                       T : []
                           Rhobi Wambura : ['Motiba Wambura', 'Rhobi Wambura', 'Teonas Wambura']
                                Kurrp Ki : ['Kurrp Ki']
                      Plan International : ['Care International', 'Compasion International', 'Living Water International', 'Lotary International', 'Muslimehefen International', 'Plan Internatio', 'Plan International']
                               Tcrs/care : ['Cipro/care', 'Tcrs /care', 'Tcrs/care']
                        District Council : ['Cdtfdistrict Council', 'District Council', 'District Medical', 'Mbozi District Council', 'Sangea District Council', 'Sengerema District Council', 'Songea District Council', 'Wb / District Council']
                                   Jaica : ['Gaica', 'Jaica', 'Jeica', 'Jica']
                                  Vififi : ['Vifafi', 'Vififi']
                             Maji Mugumu : ['Maji Mugumu', 'Maju Mugumu']
                                     Sua : ['Sua']
                                   Wards : ['Wards']
                         Nazareth Church : ['Baptist Church', 'Nazalet Church', 'Nazareth Church', 'St Magreth Church']
                             Kkkt Church : ['Agt Church', 'Aic Church', 'Baptist Church', 'Batist Church', 'Fpct Church', 'Kkkt Church', 'Nazalet Church', 'Pag Church', 'Roman Church', 'Sda Church', 'Tag Church']
                                   Kiuma : ['Kimkuma', 'Kiuma']
                           Petro Patrice : ['Petro Patrice']
                                    Quik : ['Quick', 'Quik']
                                    Ilct : ['Elct', 'Ilct']
                         Samweli Mshosha : ['Samweli Kitana', 'Samweli Mshosha']
                                   Kanis : ['Kanis', 'Kanisa', 'Kanisani']
                                   Conce : ['Conce', 'Concen', 'Concern']
                                Chongolo : ['Chongolo']
                                     Cct : ['Cct']
                                Uhoranzi : ['Mhoranzi', 'Uhoranzi']
                                     Ccp : ['Ccp', 'Ccpk', 'Ccps']
                                      Ur : ['Ur']
                                 Long Ga : ['Long Ga']
                                      Un : ['Un']
            Egypt Technical Co Operation : ['Egypt Technical Co Operation', 'Tanz Egypt Technical Cooper']
             Tanz/egypt Technical  Co-op : ['Tanz Egypt Technical Cooper', 'Tanz/egypt Technical  Co-op', 'Tanzania Egypt Technical Co Op']
                                    Wssp : ['Rssp', 'Wdsp', 'Wrssp', 'Wsdp', 'Wssp']
                          Seleman Rashid : ['Seleman Masoud', 'Seleman Rashid', 'Seleman Seif']
                           Meru Concrete : ['Meru Concrete']
                                   Rvemp : ['Lvemp', 'Rvemp']
                                Lifetime : ['Lifetime']
                              Quick Wins : ['Quick Win', 'Quick Wings', 'Quick Wins', 'Quick Wins Scheme', 'Quickwins', 'Qwick Win', 'Tquick Wings']
                                 Quicklw : ['Quicklw', 'Quickwi']
                             Fpct Church : ['Agt Church', 'Aic Church', 'Baptist Church', 'Batist Church', 'Fpct Church', 'Kkkt Church', 'Nazalet Church', 'Pag Church', 'Rc Church', 'Roman Church', 'Sda Church', 'Tag Church']
                                  Mtambo : ['Mtambo']
                                    Fida : ['Cida', 'Fida', 'Sida']
                                    Balo : ['Ballo', 'Balo']
                                   Tirdo : ['Tardo', 'Tirdo']
                            Roman Church : ['Anglican Church', 'Lutheran Church', 'Morovian Church', 'Nazalet Church', 'Pag Church', 'Roman Catholic', 'Roman Cathoric', 'Roman Cathoric Church', 'Roman Church', 'Sda Church', 'Tag Church']
                                   Nwssp : ['Drwssp', 'Dwssp', 'Nrwssp', 'Nwssp', 'Rwssp', 'Rwsssp']
                         Sister Makulata : ['Sister Makulata']
                            Silinda Yetu : ['Silinda Yetu', 'Sindida Yetu', 'Singida Yetu']
                           Islamic Found : ['Islamic Community', 'Islamic Found', 'Islamic Society']
                                     Sda : ['Sda', 'Sida', 'Soda']
                         Kwa Ditriki Cho : ['Kwa Ditriki Cho']
                                    Meco : ['Meco']
          Oikos E.Africa/ European Union : ['Oikos E .Africa/european Union', 'Oikos E.Africa/ European Union', 'Oikos E.Africa/european Union']
          Rural Water Supply And Sanitat : ['Rural Water Supply And Sanita', 'Rural Water Supply And Sanitat']
                   Uhai Wa Mama Na Mtoto : ['Uhai Wa Mama Na Mtoto']
                     Ubalozi Wa Marekani : ['Dwe/ubalozi Wa Marekani', 'Ubalozi Wa Japani', 'Ubalozi Wa Marekani', 'Watu Wa Marekani']
                             Makapuchini : ['Makapuchini', 'Wamakapuchini']
                                     Ded : ['Ded']
                             Kayempu Ltd : ['Kayempu Ltd']
                            Kkkt_makwale : ['Kkkt_makwale']
                                     Veo : ['Veo']
                                Father W : ['Father W']
                                Magereza : ['Magereza', 'Mwingereza']
                                Dhv Moro : ['Dhv Moro', 'Dhv\\norp']
                                   Mzung : ['Mbunge', 'Mzung', 'Mzungu']
                             Fptc - Pent : ['Fptc - Pent']
                         Sharifa Athuman : ['Sharifa Athuman']
                   Shule Ya Msingi Ufala : ['Shule Ya Msingi', 'Shule Ya Msingi Ufala', 'Shule Ya Sekondari Ipuli']
                                Tasaf Ii : ['Tasaf 1', 'Tasaf Ii', 'Tassaf I', 'Tassaf Ii']
                                    Nssf : ['Nssf']
                     Villlage Contributi : ['Village Contributio', 'Villlage Contributi']
                                 Buptist : ['Babtist', 'Buptist']
                     Holili Water Supply : ['Holili Water Supply', 'Lawatefuka Water Supply', 'Losaa-kia Water Supply', 'Losakia Water Supply', 'Makonde Water Supply', 'Rural Drinking Water Supply', 'Rural Water Supply']
                          Rafael Michael : ['Rafael Michael']
                                   Hw/rc : ['Hw/rc']
                                  Drwssp : ['Ded/rwssp', 'Drwssp', 'Dwssp', 'Nrwssp']
                                   Afric : ['Afric', 'Africa', 'African', 'Africare']
                                    Lgcd : ['Lgcd', 'Lgcdg', 'Lgcgd']
                                  Ustawi : ['Ustawi']
                        China Government : ['Belgian Government', 'China Government', 'Cipro/government', 'Colonial Government', 'Danida /government', 'Egypt Government', 'Finland Government', 'Irish Government', 'Italy Government', 'Japan Government', 'Lwi & Central Government', 'Misri Government', 'Norad /government', 'Norad/government', 'Tcrs /government', 'Unhcr/government', 'Village Government']
                                   Tempo : ['Tempo']
                                    Kkkt : ['Kkkt']
                                 Islamic : ['Islamic', 'The Islamic']
                             Banca Reale : ['Banca Reale']
                         Kanisa Katoliki : ['Kanisa Katoliki', 'Kanisa Katoliki Lolovoni', 'Kanisa La Menonite']
                  Rural Water Department : ['Rural Water Department', 'Water Department']
                                      Ch : ['Ch']
                            Dmk Anglican : ['Dmk Anglican']
                                    Iucn : ['Iucn']
                                     Act : ['Act', 'Aict']
                             Lotary Club : ['Lotary Club', 'Lottery Club', 'Rotary Club', 'Rotaty Club']
                               Snv-swash : ['Snv-swash']
                                   Unice : ['Unice', 'Unicef', 'Uniceg', 'Unicet', 'Unicrf', 'Uniseg']
                                 Private : ['Private', 'Private Co']
                   Action Contre La Faim : ['Action Contre La Faim']
                       Salum Tambalizeni : ['Salum Tambalizeni']
                   Government/ Community : ['Government And Community', 'Government Of Tanzania', 'Government/ Community', 'Government/ World Bank']
